機械的で無感情=三无少女
おおらかでやさしい=开朗温柔
意識が高く自信家=独立自信
自分勝手でわがまま=任性傲娇
無気力でものぐさ=懒散无力
ポジティブで明るい=积极向上
やさしさ=温柔
快楽=快乐
小悪魔=小恶魔
刺激=刺激
礼儀=礼仪
禁断=禁断
落ち着き=安静
お金=拜金
知性=知性
信念=信念
忠誠=忠诚
持久力=持久
可憐さ=可怜
無邪気=天真
不完全=有缺陷
理解力=理解力
判断力=判断力
癒やし=治愈系
サンプル=范例
タイプ=类型
名前=名字
コーデ=服装
瞳の設定=瞳孔设定
キャラ設定=角色设定
ハート=心
肌=皮肤
顔=面部
耳=耳朵
眼鏡=眼镜
眉=眉毛
目=眼睛
鼻=鼻子
口=嘴巴
顎=下巴
首=脖子
肩=肩膀
胸=胸部
腰=腰
腕=手臂
脚=腿部
左手=左手
右手=右手
左肩=左肩
右肩=右肩
左頬=左脸颊
右頬=右脸颊
おでこ=前额
腹・股間=腹部
背中・うなじ=背部
右脚裏=右腿后方
右ふくらはぎ=右小腿肚
左脚裏=左腿后方
左ふくらはぎ=左小腿肚
右脚=右腿
左脚=左腿
右スネ=右胫
左スネ=左胫
右足=右脚
左足=左脚
左尻=左屁股
右尻=右屁股
左腕=左腕
右腕=右腕
ポニー=马尾
ツイン左=左马尾
ツイン右=右马尾
ヘアピン左=左发夹
ヘアピン右=右发夹
帽子=帽子
額=额头
頭中心=头中心
左耳=左耳
右耳=右耳
胸上=胸上
胸上中央=胸上中央
左胸=左胸
右胸=右胸
背中中央=后背中央
背中左=左后背
背中右=右后背
腰前=腰前
腰後ろ=腰后
腰右=腰右
腰左=腰左
左太もも=左大腿
右太もも=右大腿
左ひざ=左膝
右ひざ=右膝
左足首=左脚踝
右足首=右脚踝
かかと左=左脚跟
かかと右=右脚跟
左肘=左肘
右肘=右肘
左上腕=左上臂
右上腕=右上臂
左手首=左手腕
右手首=右手腕
左人差指=左食指
右人差指=右食指
左中指=左中指
右中指=右中指
左薬指=左无名指
右薬指=右无名指
下腹部①=下腹部①
下腹部②=下腹部②
下腹部③=下腹部③
種類=种类
カラー=颜色
親=位置
調整=调整
配置=配置
その他=其他
初期カラー=初始颜色
ツヤ=光泽
質感=质感
カラーサンプル=颜色范例
柄設定=花纹设定
破れ具合=破损程度
オプションパーツ01を表示=可选部件01显示
オプションパーツ02を表示=可选部件02显示
幅=宽度
高さ=高度
X位置=X轴位置
Y位置=Y轴位置
傾き=倾斜
位置X=位置X轴
位置Y=位置Y轴
位置=位置
回転=旋转
拡縮=缩放
移動量=移动量
回転量=旋转量
拡縮量=缩放量
操作軸=操作轴
移動=移动
速度=速度
大きさ=尺寸
揺らさない=禁止摇动
移動X=移动X轴
移動Y=移动Y轴
移動Z=移动Z轴
回転X=旋转X轴
回転Y=旋转Y轴
回転Z=旋转Z轴
全て初期化=全部初始化
初期親=初始位置
ピッカー=Picker
スライダー=Slider
プリセット=Preset
透明度=透明度
色合い=色彩
鮮やかさ=鲜艳度
明るさ=亮度
左クリックで適用=点击左键使用
バラ=玫瑰
汚れ=污渍
星=星
三日月=三日月
水滴=水滴
絆創膏=创可贴
十字=十字
五十字=五十字
蝶=蝴蝶
クモ=蜘蛛
クモの巣=蜘蛛网
禁止=禁止
陰陽=阴阳
キスマーク=吻痕
瞳=眼睛
ストライプ=竖条纹
ボーダー=横条纹
チェックA=方格子A
水玉=水玉
イチゴ=草莓
ハーリキンチェック=花斑方格
星B=星星B
チェックB=方格子B
千鳥格子=千鸟格子
網=网
ヒョウ=豹纹
ゼブラ=斑马
迷彩=迷彩
レンガ=砖块
編み込み=编织
市松=黑白格子
麻の葉=麻叶纹
青海波=水波
唐草=卷草纹
矢絣=箭羽
ノルデック=北欧
鹿子=鹿纹
亀甲花菱=龟甲花形
星A=星星A
ドクロ=骷髅
グラデーションボーダー=渐变纹
花柄=花纹
縦線=竖线
横線=横线
モザイク=马赛克
アーガイル=阿盖尔菱形
チマヨ=奇马约条纹
ギンガムチェック=条格子
変則ストライプ=不规则横条纹
変則ボーダー=不规则竖条纹
丸=圆
ペイズリー=佩兹利花纹
エイシェント=蚀刻纹
南国リーフ=热带树叶
ハイビスカス=木槿
スポーツ=运动
ストライプ細=细竖条纹
全体=全体
ペイント01=彩绘01
ペイント02=彩绘02
フェイス=面部
顔周り=面部周围
顔のタイプ=脸型
頬=脸颊
ホクロの設定=痣的设定
目周り=眼睛详细设定
左右の設定を合わせる=左右眼设定相同
左目=左眼
右目=右眼
目のハイライト=眼睛高光
眉のタイプ=眉毛类型
まつ毛のタイプ=睫毛类型
化粧=化妆
アイシャドウ=眼影
チーク=腮红
リップ=嘴唇
ボディ=身体
体型=体型
上半身=上半身
下半身=下半身
肌の種類=皮肤种类
日焼け跡=晒痕
乳首=乳头
アンダーヘア=阴毛
爪の色=指甲颜色
ヘアー=发型
前髪と後ろ髪の色を統一=前发与后发颜色统一
根本と毛先の色を自動設定=发根与发梢颜色自动设定
後ろ髪=后发
後ろ髪の設定=后发设定
前髪=前发
前髪の設定=前发设定
横髪=侧发
横髪の設定=侧发设定
エクステ=额外
エクステの設定=额外设定
描画設定=画面设定
衣装=衣服
トップス=上衣
ボトムス=下衣
インナー上=胸罩
インナー下=内裤
手袋=手套
パンスト=裤袜
靴下=袜子
靴=鞋子
アクセサリー=饰品
頭=头
背中=背部
手=手
スロット=插槽
オプション=设置
名前・誕生日=名字・生日
願望=愿望
キャラカード=角色卡
保存・消去=保存・删除
読込み=读取
システム=系统
状態設定表示=状态设定显示
スライダーホイール操作=滚轮操作
コンフィグ=Config
注視点の表示=注视点显示
BGM音量=BGM vol
SE音量=SFX vol
輪郭=轮廓
シワ=皱纹
強さ=强弱
ほうれい線=法令纹
目元シワ=眼睛皱纹
口元シワ=嘴巴皱纹
全体シワ1=全体皱纹1
全体シワ2=全体皱纹2
頬コケ=脸颊
頬盛り=腮帮子
目元補助1=眼睛補助1
目元補助2=眼睛補助2
目元補助3=眼睛補助3
目元補助4=眼睛補助4
目元補助5=眼睛補助5
目元補助6=眼睛補助6
目元補助7=眼睛補助7
唇強調=强调嘴唇
形状補助1=形状補助1
形状補助2=形状補助2
形状補助3=形状補助3
顔全体横幅=头部宽度
顔上部前後=上半脸前后
顔上部上下=上半脸高度
顔下部前後=下半脸前后
顔下部横幅=下半脸宽度
顎横幅=下巴宽度
顎上下=下巴高度
顎前後=下巴前后
顎角度=下巴角度
顎下部上下=下颚高度
顎先幅=下巴尖宽度
顎先上下=下巴尖高度
顎先前後=下巴尖前后
頬下部上下=下脸颊高度
頬下部前後=下脸颊前后
頬下部幅=下脸颊宽度
頬上部上下=上脸颊高度
頬上部前後=上脸颊前后
頬上部幅=上脸颊宽度
眉の幅=眉毛宽度
眉の高さ=眉毛高度
眉の位置X=眉毛位置X轴
眉の位置Y=眉毛位置Y轴
眉の傾き=眉毛倾斜
目の縦幅=眼睛深度
目横位置=眼睛间距
目前後=眼睛前后
目の横幅=眼睛宽度
目上下=眼睛高度
目の角度Z軸=眼睛角度Z轴
目の角度Y軸=眼睛角度Y轴
目尻上下位置=外眼角上下位置
目尻左右位置=外眼角左右位置
目頭上下位置=内眼角上下位置
目頭左右位置=内眼角左右位置
まぶた形状１=眼睑形状1
まぶた形状２=眼睑形状2
鼻全体上下=鼻子高度
鼻全体前後=鼻子前后
鼻全体角度X軸=鼻子角度
鼻全体横幅=鼻子宽度
鼻筋高さ=鼻梁高度
鼻筋横幅=鼻梁宽度
鼻筋形状=鼻梁形状
小鼻横幅=小鼻宽度
小鼻上下=小鼻高度
小鼻前後=小鼻前后
小鼻角度X軸=小鼻角度X轴
小鼻角度Z軸=小鼻角度Z轴
鼻先高さ=鼻尖高度
鼻先角度X軸=鼻尖角度X轴
鼻先サイズ=鼻尖尺寸
口上下=嘴巴高度
口横幅=嘴巴宽度
口縦幅=嘴巴厚度
口前後位置=嘴巴前后位置
口形状上=嘴巴形状上
口形状下=嘴巴形状下
口形状口角=嘴角
耳サイズ=耳朵尺寸
耳角度Y軸=耳朵角度Y轴
耳角度Z軸=耳朵角度Z轴
耳上部形状=耳尖形状
耳下部形状=耳垂形状
ホクロ=痣
ホクロ２=痣2
ソバカス=雀斑
ソバカス２=雀斑2
左の口元=左嘴角
右の口元=右嘴角
左の口上=左嘴上
右の口上=右嘴上
左の目元=左眼
右の目元=右眼
額中央=额中央
そばかす=雀斑
ホクロの幅=痣的宽度
ホクロの高さ=痣的高度
ホクロの位置X=痣的位置X轴
ホクロの位置Y=痣的位置Y轴
白目=眼白
瞳の種類=眼睛种类
瞳孔種類=瞳孔种类
瞳孔設定=瞳孔设定
発光=发光
設定=设定
高さ調整=高度调整
影の範囲=阴影范围
身長=身高
頭サイズ=头部尺寸
胸サイズ=胸部尺寸
胸上下位置=胸部上下位置
胸の左右開き=胸部外扩程度
胸の左右位置=胸部左右位置
胸上下角度=胸部上下角度
胸の尖り=胸部凸起
胸の柔らかさ=胸部柔软度
胸の重さ=胸部重量
乳輪の膨らみ=乳晕凸起
乳輪の大きさ=乳晕大小
乳首太さ=乳头大小
乳首立ち=乳头凸起
首周り幅=脖子宽度
首周り奥=脖子厚度
胴体肩周り奥=肩膀厚度
胴体肩周り幅=肩膀宽度
胴体上幅=上身宽度
胴体上奥=上身厚度
胴体下幅=下身宽度
胴体下奥=下身厚度
ウエスト位置=腰部位置
腰上幅=腰部宽度
腰上奥=腰部厚度
腰下幅=骨盆宽度
腰下奥=骨盆厚度
尻=屁股
尻角度=屁股角度
上腕=上臂
前腕=前臂
太もも上=上大腿
太もも下=下大腿
ふくらはぎ=小腿肚
足首=脚踝
肉感=肉感
肉感の強さ=肉感强度
普通=普通
ムキムキ=肌肉
ポッチャリ=丰满
スレンダー=苗条
ワンピースライン１=连衣裙1
ワンピースライン２=连衣裙2
レーシングライン=竞赛泳衣
スクール水着ライン=死库水
ビキニライン=比基尼
マイクロライン１=小型比基尼1
マイクロライン２=小型比基尼2
チューブトップライン=抹胸
ランジェリーライン=女士内衣
キャミソールライン=吊带
スポーツライン=运动衣
体操着ライン=体操服
ナチュラルライン1=自然晒痕1
ナチュラルライン2=自然晒痕2
四角=四角
円形=圆形
薄小=薄小
薄四角=薄四角
薄円形=薄圆形
小円形=小圆形
大三角=大三角
小三角=小三角
Iライン=I形
細Iライン=细I形
長菱=菱形
まばら=稀疏
ナチュラル=自然
ショートヘア=短发
ウェーブロング=波浪长发
外はねミディアム=外羽中发
外はねショート=外羽短发
ストレートロング=直长发
くせっけショート=卷短发
ボリュームポニー=马尾
細ツインテール=细双马尾
セミロング=半长发
ぱっつんロング=齐长发
ツイン前おさげ=前双辫
後ろおさげ=后辫
はねっけロング=羽毛长发
ツインロール=双马尾卷发
ぱっつんミディアム=齐中发
横おさげ=横辫
ロングヘア=长发
くせっ毛ショート=卷短发
横分け=中分
エムバング=三分
梳き髪=梳发
姫カット=公主头
でこだし中わけ=高中分
片目隠し=遮住眼睛
はねっ毛=羽毛发
アシンメトリ=不对称
ぱっつんミデイアム=齐中发
切り揃えショート=剪齐短发
太もみあげ=粗鬓角
ロングもみあげ=长鬓角
細もみあげ=细鬓角
カール=卷发
ポニーおくれ毛=马尾
三つ編み=麻花辫
細三つ編み=细麻花辫
横あほ毛=横呆毛
2本あほ毛=2根呆毛
上向きあほ毛=冲天呆毛
前あほ毛=前呆毛
お団子=团子头
編みカチューシャ=编发箍
後ろ編み込み=后编发
髪設定=头发设定
滑らかさ=平滑
基本カラー=基本颜色
根本カラー=Root Color
毛先カラー=Tips Color
ツヤカラー=Glossy Color
装飾設定=Decoration Settings
ワンピース=连体
Tシャツ=T恤
キャミソールA=吊带A
ショートパンツ=短裤
ホットパンツ=热裤
プリーツスカート=百褶裙
ノーマル=普通
リボンビキニ=丝带比基尼
軍手=工作手套
ストッキング=裤袜
ソックス=短袜
ビーチサンダル=沙滩凉鞋
ヘアピン=短发夹
うさ耳リボン=爽哥
スター=星星
スクエア=方形眼镜
ピエロの鼻=小丑鼻
コアキューブ=核心方块
トートバッグ=单肩背包
シンプルリング=乳环
ウエストバッグ=腰包
リュック=背包
腕章A=臂章A
シンプル指輪=戒指
ミサンガA右=右腿编织带A
ミサンガA左=左腿编织带A
ランダム=随机
誕生日=生日
月=月
日=日
声質=音色
女の子に求める願望（最大３つ）=对女孩的愿望（最多3个）
消去=删除
新規保存=新存档
上書き保存=覆盖保存
体=身材
髪=发型
ソート=排序
日付=日期
状態設定=状态设定
視線=视线
カメラ=镜头
正面=正面
ポーズ=姿势
服状態=衣服状态
自動=自动
着衣=穿衣
下着=内衣
全裸=全裸
装飾=装饰
表示=显示
非表示=不显示
ライト向きX=光线方向X轴
ライト向きY=光线方向Y轴
ライト強さ=光线强度
背景=背景
単色=单色
画像=图像
撮影メニュー=摄影菜单
目の開き=眼睛睁开
口の開き=嘴巴张开
背面フレーム=背景
前面フレーム=相框
戻る=返回
保存=保存
本当に上書きしますか？=真的要覆盖吗?
本当に削除しますか？=真的要删除吗?
終了しますか？=要结束游戏吗？
確定=确定
キャンセル=取消
なし=无
コピー=复制
終了=结束
スロットをコピー=复制插槽
初期化=初始化
特殊=特殊
柄=花纹
色相=Hue
彩度=Saturation
服読込み=服装读取
全て読込み=全部读取
明度=Brightness
コピー先を選択=选择复制目的地
キャラカードA=角色卡A
キャラカードB=角色卡B
調整①を上下反転=调整①上下反转
調整②を上下反転=调整②上下反转
調整①を左右反転=调整①左右反转
調整②を左右反転=调整②左右反转
調整①=调整①
調整②=调整②
衣装カード=服装卡
ホクロのタイプ=Mole Type
左クリックで現在のカラーを登録=点击左键保存现在的颜色
コピー元を選択=选择复制源
装飾読込み=装饰读取
掛け合わせる=合体
ふたなり=大屌萌妹
調整値のコピー=复制调整值
肌のタイプ=Skin Type
コピーする=执行复制
下腹部=下腹部
左右の親を変更=改变左右位置
融合=融合
髪の調整をまとめて行う=头发一起调整
