顔面騎乗・背面騎乗位=Face sit / back cowgirl
キス=Kissing
添い寝キス=Lying Kiss
胸いじり=Breast Fondle
股間いじり=Fingering
クンニ=Cunnilingus
マングリ股間いじり=Mangling between the crotch
マングリクンニ=Manglikunni
キスオナニー=Kiss masturbation
アナル舐め=Analingus
アナルバイブ挿入=Anal Vibrator Insertion
顔面騎乗クンニ=Face Sitting Cunnilingus
無理やりキス=Forced kiss
立ちキス=站立之吻
立ちクンニ=站立的舔阴
Ｇスポット攻め=G-Spot Attack
立ちバイブ挿入=Standing Vibrator
拘束二穴バイブ=Double Vibrator
後ろから胸もみ=从后面的揉胸
椅子クンニ=Chair Cunnilingus
後ろからクンニ=Cunnilingus from behind
立ち前バイブ=Vibe before standing
階段手マン=楼梯上手淫
階段胸もみ=楼梯上揉胸
壁立ちバッククンニ=墙站立背舔阴
ソファークンニ=Sofa Cunnilingus
しゃがみ胸もみ=Crouching chest fir
机クンニ=Desk Cunnilingus
フェラ=吹箫
手コキ=打手枪
亀頭いじり=龟头到处乱
パイズリ=乳交
パイズリ舐め=舔奶
パイズリ咥え=操蛋
乳首舐め手コキ=Nipple Licking Fellatio
チングリアナル舐め=Ching Liar Licking
立ち足コキ=Standing Footjob
脱力手コキ=Weak handjob
脱力フェラ=Weakness Fellatio
立ち手コキ=正常打手枪
ノーハンド先舐め=无手舔
ノーハンドフェラ=没有手口交
ディープスロート=Deepthroat
立ちパイズリ=乳交
立ちパイズリ舐め=站立奶舔
拘束フェラ=Restraint Fellatio
嫌がり手コキ=讨厌的打手枪
無理やりフェラ=强迫口交
椅子手コキ=Handjob on chair
椅子ノーハンドフェラ=Sitting No-Hand Blowjob
椅子パイズリ=Sitting Boobjob
椅子パイズリ舐め=Sitting Licking Boobjob
椅子足コキ=Sitting Footjob
壁穴フェラ=Gloryhole Fellatio
しゃがみフェラ=Crouching Fellatio
ソファーフェラ=Sofa Fellatio
風呂足コキ=Bath Footjob
机手コキ=Handjob
貝合わせ=Shellfish
立ち股間いじり=Teasing between thighs
壁立ちクンニ=Wall standing cunnilingus
机バッククンニ=Desk back cunnilingus
貝合わせ・受け=Shellfish (Receiving)
立ち股間いじり・受け=Teasing between thighs (Receiving)
壁立ちクンニ・受け=Wall standing cunnilingus
椅子クンニ・・受け=Chair Cunnilingus (Receiving)
机バッククンニ・受け=Desk back cunnilingus (Receiving)
正常位=Missionary
胸もみ正常位=Breast Fondling Missionary
後背位=Doggy Style
中腰バック=Kneeling Behind
側位=Spooning
騎乗位=Cowgirl
胸もみ騎乗位=Chest fir cowgirl
背面騎乗=Reverse Cowgirl
マングリ正常位=Mangli normal
屈脚位=Bent Missionary
ブリッジピストン=Double Decker
アナル正常位=Anal Missionary
アナル後背位=Anal Doggystyle
女主導騎乗位=Cowgirl (Her Lead)
女主導背面騎乗位=Reverse Cowgirl (Her Lead)
チングリピストン=Reverse Piledriver
女主導騎乗素股=Cowgirl Humping (Her Lead)
女主導手コキ素股=Handjob Humping (Her Lead)
拘束正常位=Floor Bondage Missionary
嫌がり正常位=Forced Missionary
立位=站立后背位
立ちバック=站立正面位
突き上げバック=Thrust Behind
駅弁=Lifting
逆駅弁=Reverse Lifting
素股=背后素股
立ち拘束=Stockade
壁立ちバック=靠墙站立
アナル壁立ちバック=肛门墙站立
椅子背面座位=Chair back seat
アナル椅子後背位=Anal Doggy on Chair
女主導椅子素股=Sitting Humping (Her Lead)
卓上正常位=Desk Missionary
机側位=Desk Side Position
机後背位=Doggy Style on Desk
カウンターバック=Counter back
階段後背位=楼梯后背位
壁穴後背位=Wall hole doggy style
しゃがみ挿入=Crouch insertion
またがり挿入=Straddle insertion
ソファー側位=Sofa on side
ソファー騎乗位=Sofa cowgirl
風呂挿入=Bath Insertion
分娩台挿入=Desk Insertion
シックスナイン=69
しゃがみオナニー=Crouch Masturbation
ディルドオナニー=Dildo Masturbation
カメラ撮影オナニー=Camera Shoot Masturbation
寝オナニー=Sleeping Masturbation
角オナニー=Corner Masturbation
階段オナニー=Stairs Masturbation
ソファシックスナイン=69 On Sofa
シャワーオナニー=Shower Masturbation
トイレオナニー=Toilet Masturbation
三角木馬=Spanish Donkey
手縛り三角木馬=Hand tied triangle horse
鉄球手縛り三角木馬=Iron ball hand triangle horse
拘束玩具攻め=Restraint toy attack
