決定=决定
戻る=返回
選択したセーブデータを削除=删除所选的保存数据
項目選択=项目选择
拡大・縮小=放大/缩小
マップを閉じる=关闭地图
廃墟の島=废墟之岛
sr:"^(：?拠点)(：)(.*)$"=$1$2 $3
拠点=基数
：拠点=: Base
シャンの家=珊的房子
廃墟=Ruins
浜辺=Beach
森=Forest
ハウジング島=Housing Island
sr:"^(：)(.*)$"=$1 $2
グローブ=二级手套
虫網=一级捕虫网
シャベル=一级铲
ツルハシ=一级镐
アイテムボックス=Item Box
端末=Terminal
ベッド=Bedding
椅子=Seating
畑=田地
料理=做饭
風呂=Bathing
トイレ=Toilet
ステータス=状态
ポーチ=包裹
マップ=地图
クラフト=制造
カメラ=镜头
コール=呼叫
ヘルプ=帮助
ログ=日志记录
セーブ=保存
オプション=设置
装備=装备
道具=道具
装飾=装饰
性別=性别
ポーチ容量=袋容量
スロット=插槽
釣り熟練度=钓鱼技巧
プレイ時間=上场时间
装備を外す=Remove Equipment
男性=Male
体温=体温
満腹度=饱足感
疲労=疲劳感
機嫌=心情
やる気=有活力
腹痛=胃痛
過労=Exhausted
エッチな気分=H的心情
ライフスタイル：=生活方式：
女子力=女子力
信頼=信任度
人間性=人性
本能=本能
変態=变态
警戒=警惕
社交=社交
闇=黑暗
スキル=技能专长
通常=Normal
エッチ=H
やればできる子=学龄前属性
行動中、まれに成長が普段より早くなる。=在行动中，成长很少会比平时快。
すべて=全部
草花=花草
樹木=树木
魚=鱼
種=种子
エサ=食物
飲み物=饮品
料理=做饭
薬=医药
ペット=宠物用品
プレゼント=礼物
貴重品=贵重物品
素材=材料
//スキル=Skill(s)
Hスキル=H技能
種類=种类
名前=名字
グレード=等级
レート=价格
所持数=持有数量
ソート=排序
入手順=程序
//名前=Name
レアリティ=稀有度
カテゴリー=类别分类
一括で送る=批量发送
個数=个数
入手アイテム=获得物品
収穫までの時間=收获时间
栽培完了！！=Cultivation Complete!!
植える=种植
受け取る=收到
一括受け取り=一次性领取
r:"^(.*)にアクション$"=r:"Interact with $1"
r:"^(.*)と話す$"=r:"Talk with $1"
r:"^(.*)を担ぐ$"=r:"Carry $1"
下ろす=下层
ベッドに寝かせる=上床睡觉
一緒にご飯を食べる=Eat Rice Together
野花の種をあげる=培养野花的种子
データ端末=Data Terminal
釣りを始める=Start Fishing
捕まえる=赶上
ジャンプ=Jump
くぐる=穿过
渡る=Cross
明かりをつける=Turn On Light
明かりを消す=关掉灯
扉を開ける=开门
扉を閉める=关上门
中を探る=探索内部
調べる=Inspect
地面を探る=探索地面
虫を取る=取虫
シャベルで掘る=用铲子挖
ピッケルで掘る=用稿子挖
机の上のものを取る=在桌子上拿东西
椅子に座る=坐下
寝る=睡觉
拠点=基数
チェスト=仓库
調理台=炉灶面
畑=田地
トーク=谈话
アドバイスする=建议
アイテムを渡す=赠送礼物
薬をあげる=服药
ついてきて=跟我来
エッチがしたい=我想和你做爱
印象を聞く=听印象
調子どう？=你好吗
誰と仲良し？=你和谁在一起？
お気に入りの場所は？=你最喜欢的地方是？
おだてる=生气
エッチな会話=色色的谈话
寝に行ったら？=去睡觉吧？
少し休んだら？=休息一下吧？
採取手伝って=帮忙收集吧？
なにか食べたら？=吃点什么吧
なにか飲んだら？=喝点什么吧
料理作って=做饭
たまには気分転換を=偶尔改变一下心情
エッチな行動を要求=要求羞羞的行为
容姿についてほめる=外观上的称赞
内面についてほめる=里面的赞美
起こす=Wake Up
エッチなことをする=做羞羞的事情
リードする=前戏
してほしい=我要你
いきなり挿入する=直接插入
話す=Talk
ショップ=铺
エッチさせて=Ask For Sex
女の子を変更=更换女孩
女の子の容姿変更=女孩的外貌变更
r:"^(.*)を変更$"=r"Change $1"
r:"^(.*)の容姿変更"=r:"Change $1's Appearance"
キャラ編集=角色编辑
ハウジング=房屋
立ち去る=离开
睡眠=睡觉
そのまま寝転ぶ=躺下
//寝る=Sleep
起きる=起床
料理をする=Cook
貯蔵庫を見る=View Storehouse
立ち上がる=站起来
移動=移动
ズーム=变焦
撮影=撮影
終了=结束
親密度=亲密度
交換レート総額=交易总额
在庫=存货
通常商品は7:00に内容が更新されます。=常规产品将在7:00更新。
スペシャルアイテムは更新されませんが、\n一回限りの購入になります。=特殊商品不会更新，而是一次性购买。
購入アイテム=购买物品
購入するアイテムを選択してください。=请选择要购买的物品。
渡すアイテム=要通过的项目
ポーチから渡すアイテムを選択してください。=请从包装袋中选择您想通过的物品。
交換=成交
上で続ける\n下で抜く=Continue\nPull Out
続ける=继续
