※ インストールフォルダ/UserData/chara/ に入っていた体験版のデータは/UserData/chara/old/ に移動します。=*安装文件夹/ UserData / chara /中的试用版数据将被移至/ UserData / chara / old /。
「キャラメイク体験版」のデータを「AI＊少女」のデータに変換します。=将“角色化妆试用”数据转换为“ AI *女孩”数据。
※ ファイル数が多いと時間がかかる可能性があります。=*如果文件太多，可能需要一些时间。
キャラデータ=角色数据
女だけ島と柳哲郎の猫対決の遊戯劇=志摩与柳木哲郎之间的对决
選択したセーブデータを削除=删除所选的保存数据
ワールドネーム=世界名
ロードしますか？=您要加载吗？
スクロール=卷动
もどる=回程
トーク=谈话
コマンド=命令
ボイス再生=语音播放
アイテム整理=项目安排
一括で送る=批量发送
アイテム名=项目名称
フレーバーテキスト=风味文字
衣装カードを選択してください=请选择服装卡
カテゴリー=类别分类
入手順=程序
ソート=排序
日 付=日期
名 前=名称
脱衣所=更衣室
衣装棚=晾衣架
プレイヤーを選択してください=选择一个玩家
女の子を選択してください=选择一个女孩
キャラ作成=角色创作
決 定=决定
性別 : =性别：
ステータス=状态
通常スキル=普通技能
エッチスキル=H技能
ライフスタイル : =生活方式：
女子力EXP=女子力经验
信頼EXP=信任经验
人間性EXP=人性经验
本能EXP=本能经验
変態EXP=变态经验
警戒EXP=警惕经验
社交EXP=社交经验
闇EXP=黑暗经验
女の子を変更=更换女孩
主人公を変更=更换男主
あいうえおかきくけこ=欢迎
女の子の容姿変更=女孩的外貌变更
キャラ編集=角色编辑
主人公の容姿変更=男主外貌的变化
住む島を変更=改变你居住的岛屿
ミミズ=蚯蚓
トトロバ=龙猫
レアリティ=稀有度
釣り熟練度=钓鱼技巧
取得Exp=获得经验
レベルアップ!!=升级！
発電装置を修理しますか？=您要修理发电机组吗？
合金材=合金材质
フェーズ２の女の子がいません=第二阶段没有女孩
項目選択=项目选择
残り成長回数=剩余增长数量
ズーム=变焦
撮影=撮影
親密度=亲密度
交換レート総額=交易总额
廃墟の島=废墟之岛
ショップ=铺
グレード=等级
レート=价格
在庫=存货
通常商品は7:00に内容が更新されます。=常规产品将在7:00更新。
スペシャル=特别的
スペシャルアイテムは更新されませんが、\n一回限りの購入になります。=特殊商品不会更新，而是一次性购买。
購入アイテム=购买物品
購入するアイテムを選択してください。=请选择要购买的物品。
交換=成交
渡すアイテム=要通过的项目
ポーチから渡すアイテムを選択してください。=请从包装袋中选择您想通过的物品。
頼まれもの=受托的东西
渡す=交出
植える=种植
入手アイテム=获得物品
個数=个数
ポーチがいっぱいのため受け取れないアイテムがあります。=由于包装袋已满，无获得某些物品。
一括受け取り=一次性领取
受け取る=收到
畑=田地
収穫までの時間=收获时间
追加=新增
タマゴ箱=鸡蛋盒
ニワトリ小屋=鸡小屋
逃がす=离开
名前変更=重命名
ついてくる=跟随
BGM変更=BGM变化
変更=改变
セット=设置
ガラクタを片付けますか？=收垃圾吗？
閉じる=关门
ポーチ=包裹
マップ=地图
クラフト=制造
コール=呼叫
ヘルプ=帮助
ログ=日志记录
セーブ=保存
私立他の時政寄りササニシキ琴三郎=与其他私人政治关系密切的小三郎
性別=性别
ポーチ容量=袋容量
プレイ時間=上场时间
装備=装备
道具=道具
スキル=技能专长
エッチ=H
すべて=全部
所持数=持有数量
空き=空的
採取とは=什么是采集？
キッチンについて=关于厨房
女の子について=关于女孩
コミュニケーション=沟通交流
エッチについて=关于H
端末について=关于终端
睡眠について=关于睡眠
装備アイテム=设备项目
釣り=垂钓
チェスト=仓库
拠点ポイント=路标
ハウジング=房屋
畑の使い方=如何使用种植园
ローディング画像=正在载入图片
必要素材=必要的材料
作成=建立
ポーチがいっぱいです。=小袋已满。
調合=配方
ペット合成=宠物合成
料理=做饭
装備クラフト=设备工艺
素材クラフト=材料工艺
貯蔵庫=贮藏
マップを閉じる=关闭地图
拡大・縮小=放大/缩小
拠点：廃墟=基础：废墟
拠点：森=基础：森林
シャンの家=珊的房子
拠点：浜辺=基地：海滩
琳=琳
：プレイヤー=：玩家
船で違う島に行ってみよう=乘船去另一个岛
放尿癖=小便处
シプレ・コロン=社交香水
寂しがりや=寂寞属性
恋愛小説=爱情小说
栄養剤=营养剂
巫女の血族=巫女属性
ソリバナナイモ=大香蕉马铃薯
アンバー=本能宝石
胸が弱い=胸部敏感属性
奉仕好き=服务爱好属性
ウズラタマゴダケ=小鸡蛋蘑菇
絵本=图画书
拘束具=拘束用具
鉄くず=铁屑
ナナイロコウロギ=七彩蚂蚱诱饵
チョウ=蝴蝶
シャンのカギ=山的钥匙
ホットコーヒー=热咖啡
ガーネットジュース=石榴汁
ツールリュック=工具背包
花のリング=花环手链
グローブ=二级手套
フローラル・コロン=女子力香水
金管草=金管草
シトラス・コロン=人性香水
ファッション誌=时尚杂志
利尿薬=利尿剂
赤い種=红果种子
バナナの種=香蕉种子
枝=树枝
フルーツワーム=水果蠕虫诱饵
大食い=暴食属性
コーヒー豆=咖啡豆
ビデオカメラ=摄影机
携帯用ランプ=手提灯
ランプ=台灯
松明=火把
丈夫な虫網=二级昆虫网
頑丈な虫網=三级昆虫网
頑丈なグローブ=三级手套
ガイドブック=警觉+50书
シリコン=硅胶
ゴム=橡胶
野花の種=野花种子
樹脂=树脂
赤い実=红色水果
空き缶=空罐
オオカワエビ=大河虾
空き瓶=空瓶
敏感=敏感属性
バッタ=蚱蜢诱饵
お湯=热水
野花=野花
ミニリュック=迷你背囊
丈夫な革=耐用的皮革
汚れた帽子=脏帽子
捕獲ゲージ=捕获笼子
上質なシャベル=三级铲
丈夫なシャベル=二级铲
シャベル=一级铲
虫網=一级捕虫网
濡れタオル=湿毛巾
燃料=燃料
綿花=綿花
ツルハシ=一级镐
丈夫なツルハシ=二级镐
カエル=青蛙
痴女=痴女属性
風邪薬=感冒药
カップ麺=杯面
破れたカバン=破损的袋子
川の水=河水
つる=藤蔓
綿花の種=棉花种子
綿=棉布
丈夫な布=耐用的布
布=布料
ロープ=绳索
火照り=欲火属性
収集家=收藏属性
シトリン=黄宝石+100变态
蛇皮=蛇皮
解熱草=解热草
霧雨草=霧雨草
ヤシの実=棕榈果
飲み水=喝水
ガーゼ=纱布
油=油
ホログラム=全息手环
釣り竿=钓鱼竿
錆びた腕輪=生锈的手镯
欠けたツルハシ=破损的镐
朽ちたシャベル=破损的铲
壊れた虫網=破损的虫网
ボロボロの手袋=破损的手套
折れた釣り竿=破损的鱼竿
電子回路=电子电路
コネクター=连接器
魚団子=鱼饺鱼饵
パイプ=管子
プレート=铁板块
金具=金属配件
鉄材=铁
カーボン=碳纤维材料
炭材=木炭
木の板=木板
角材=方木
木材=木皮
流木=浮木
ガラス片=一块碎玻璃
石材=石材
廃材=废木
焼き魚=烤鱼
コツブウオ=短爪鱼
ハンドライト=手提灯
バッテリー=电池
破れた革=撕裂的皮革
ルビー=红宝石+100本能
媚薬=春药
動物好き=爱好动物属性
ココナッツスープ=椰子汤
ローション=乳液
週刊誌=黑暗杂志+100黑暗
穴掘りマニア=挖掘属性
妖精の羽=精灵的翅膀
お尻が弱い=屁股敏感
グルメ雑誌=美食杂志+50本能
図鑑=图画书
レズ好き=女同属性
アダルト誌=成人杂志
ダークマター=暗物质
ウリの種=黄瓜种子
ニガウリ=苦瓜
ニワトリ=野鸡
ヌタウナギ=日本鳗鱼
グリーン・コロン=信任香水
オリエンタル・コロン=变态香水
フゼア・コロン=警觉香水
グルマン・コロン=黑暗香水
デカニガウリ=大苦瓜
バナナイモ=香蕉马铃薯
独りよがり=寂寞属性
色欲魔=性欲属性
不満=不满属性
壊されたい=受虐属性
テクニシャン=侍奉属性
性嫌悪=性厌恶属性
お尻好き=电臀属性
同性好き=女同属性
外好き=外射属性
股間が好き=喜好下体属性
股間が弱い=下体敏感属性
中好き=中出属性
ロマンチスト=浪漫主义属性
名器=名器属性
料理好き=厨师属性
ハンター=猎手属性
虫コレクター=捕虫属性
ラッキー=好运属性
ずぼら=体温超控属性
強運=欧皇属性
根性=毅力坚决属性
地形把握=地形掌握属性
勇気=勇气属性
深い闇=腹黑属性
病弱=易感冒属性
不幸=不幸属性
潔癖=洁癖属性
なまけ=懒惰属性
超感覚=心灵相通属性
行動派=行动派属性
おしゃべり=好说话属性
話し上手=更好说话属性
忍耐=忍耐属性
体調管理=爱惜身体属性
心の壁=防备属性
疑い深い=可疑属性
神経質=神经质属性
呪われた体=淫魔诅咒属性
好奇心=好奇心属性
性欲旺盛=性欲旺盛属性
遊び好き=爱玩属性
むっつり=污属性
獣使いの素質=兽王属性
物資調達=手工收集属性
野生=野性属性
雨好き=天气之子属性
疲れ知らず=不知疲倦属性
強欲=物质少女属性
作物の知識=农民属性
ドジ=易受伤属性
釣り好き=垂钓爱好者属性
良妻賢母=贤妻良母属性
親愛=亲爱属性
反応好き=礼尚往来属性
チョロい=轻松属性
やればできる子=学龄前属性
眠り姫=睡美人属性
綺麗好き=泡澡属性
アンチ：社交=反：社交
アンチ：警戒=反：警戒
アンチ：変態=反：变态
アンチ：本能=反：本能
アンチ：闇=反：黑暗
アンチ：人間性=反：人性
アンチ：信頼=反：信任
アンチ：女子力=反：女子力
ブラックダイヤ=黑钻石
ダイヤ=钻石
アメジスト=紫水晶
アクアマリン=蓝宝石
アニマリック・コロン=本能香水
抱きつきキュービー=小手环
キュービーヘッド=恶魔头饰
暴走の右手=失控的右手
ネコリュック=猫背囊
鳥かご=鸟笼
頭乗りヒヨコ=头骑小鸡
頭乗りネコ=头骑猫
頭で跳ねる魚=头上鱼弹跳
妖精=精灵
キュービー=库比机器人
闇の精霊=黑暗之灵
ヒヨコ=小鸡
ネコタンク=坦克猫
お魚くわえたネコ=衔鱼的猫
ネコ=猫咪
胃腸薬=胃肠药
快感剤=兴奋剂
睡眠薬=安眠药
豪華ブイヤベース=豪华的法式海鲜汤
フィッシュソテー=鱼炒蛋
クラブシチュー=乱炖俱乐部
オムレツ=煎蛋卷
カップ麺3分後=3分钟后杯面
チャンプル=苦瓜炒鸡蛋
バナナイモサラダ=香蕉苦瓜沙拉
フライドポテト=炸薯条
ゆでタマゴ=煮鸡蛋
タマゴ=生鸡蛋
ココナッツ酒=椰子酒
疑似餌=假饵
魚雷=鱼雷
トアバ=十叶鱼
猫魚=猫鱼
長靴=长靴
オニブダイ=奥尼布袋鱼
ヤリマス=亚里木斯鱼
オッチャン=欧尚鱼
コムツ=小松鱼
エメラルド=翡翠石
上質なツルハシ=三级镐
草花=花草
樹木=树木
魚=鱼
エサ=食物
飲み物=饮品
薬=医药
ペット=宠物用品
プレゼント=礼物
貴重品=贵重物品
素材=材料
Hスキル=H技能
主人公=主角
体温=体温
満腹度=饱足感
疲労=疲劳感
機嫌=心情
やる気=有活力
エッチな気分=H的心情
腹痛=胃痛
ライフスタイル：=生活方式：
女子力=女子力
信頼=信任度
人間性=人性
本能=本能
変態=变态
警戒=警惕
社交=社交
闇=黑暗
予備ポーチ4=备用袋4
予備ポーチ3=备用袋3
予備ポーチ2=备用袋2
予備ポーチ1=备用袋1



椅子に座る=坐下
机の上のものを取る=在桌子上拿东西
虫を取る=取虫
エッチな気分の初期値に10％上昇する。=调皮情绪的初始值增加10％。
女の子がマップ中でオナニーすると行動終了後に本能が少し上がる。=当一个女孩在地图上手淫时，动作结束后她的直觉就会升高。
女の子の快感ゲージの上昇速度が少し上がる=女孩的游标的速度略有上升。
女の子から誘われるエッチが過激な女主導エッチに変わり、主人公が襲われるようになる。=从女孩那里邀请的蚀刻变成了激进的女性蚀刻，英雄便受到了攻击。
エッチ中に股間系挿入エッチを選択して一回でも絶頂するとエッチ終了後に信頼が少し上がる。=如果您在蚀刻过程中选择了部插入蚀刻，甚至达到一次顶点，则蚀刻结束后信任度会提高一点。
グレード2のアイテムを拾ってきやすくなる。=更容易拿到2级物品。
アイテムを拾いに行きやすくなる。=使拾起物品更加容易。
おだてるで機嫌がよくなりやすくなる。=心情轻松很容易。
体が濡れたときの体温低下を防ぎ、さらに闇が増えづらくなる。=防止人体潮湿时体温下降，并使黑暗度难以增加。
種=种子
滅多に出会えない太く立派に反り返ったバナナイモ。かなり貴重な一本。=很少见到的香蕉土豆，已经反弹得很厚。\n一本非常有价值的书。
茶色くて小さい豆。軽くて芳ばしい香りがする。=棕色和小豆。\n清淡而芬芳。
バナナの仲間だが、甘みが無く味もイモに近い。種が多く調理しないと食べられない。=尽管它是香蕉伴侣，但它并不甜，味道类似于土豆。\n除非你煮很多种子，否则你不能吃它。
一般的なヤシの実。かたい殻の中にたっぷりと水分が詰まっている。=常见的棕榈果。\n硬壳中有很多水分。
一般的な木の枝。しなりもよく、そこそこ丈夫。=普通的树枝。\n感觉很好，还可以。
木から採れる樹液。とろりとした粘りと独特の匂いがある。=树木的汁液。\n有浓稠的粘性和独特的气味。
赤く熟した果実。食べたら美味しそうだ。=红色成熟的水果。\n如果吃的话看起来很好吃。
小さな卵の形をした食用キノコ。胃腸薬の材料になる。=以小鸡蛋形状的可食用蘑菇。\n它成为胃肠道药物的材料。
すこし丈夫な植物の蔓。加工すれば何かにつかえそう。=稍强的植物藤。\n似乎可以将其用于某些处理的东西。
太く大きく育ったニガウリ。ここまで育つ事は滅多にない。=一种苦瓜，又长又大。\n到目前为止，我很少长大。
表面にイボイボがある細長い緑の植物。食べるとかなり苦い。=一种细长的绿色植物，表面上有疣。\n吃起来很苦。
親指ほどの大きさの白い綿毛の花。繭の様にも見える。=一朵白色的绒毛花，约一个拇指大小。\n它看起来像蜘蛛。
風邪状態の女の子にあげると熱を下げる効果があるが、このままでは効果は薄い。=如果给感冒的女孩服用，会降低热量的效果，但是如果保持热量，效果会更差。
小さな花が咲く野草。茎にツヤがあり、油分を多く含んでいる。=有小花的野花。\n茎是有光泽的，并且含有很多油。
摂取すると寝つきが良くなるが、多用は厳禁。睡眠薬などの材料にも使われる。=摄入可改善睡眠，但严格禁止大量使用。\n也用于安眠药和其他材料。
やわらかい多肉植物。集めると飲み水が確保できる。=软肉质植物。\n可以保证饮用水。
口髭の生えたような顔の中型の魚。=中型鱼，脸像小胡子。
とても美味しいため重宝される大型の高級魚。=大型豪华鱼，非常美味和有用。
赤い甲羅が特徴のカニ。レッドクラブとも呼ばれる。=以红壳为特征的螃蟹。\n也称为红色俱乐部。
小さな種類の魚。小粒だが貴重な食糧。=一种小鱼。\n小而有价值的食物。
丸く太った小さな魚。雑食性で脂身が多い。=一条圆胖的小鱼。\n它是杂食性和脂肪。
媚薬の材料になるとても貴重な高級魚。=一种非常有价值的豪华鱼，可以用作壮阳药。
ウナギのような見た目の魚。体から特殊な粘液を出す。=一条看起来像鳗鱼的鱼。\n从身体扑灭特殊的粘液。
丈夫な皮を持った大型の魚。=一条大鱼，皮肤结实。
ネコが好んで食べる魚。食用にもなる。=猫喜欢吃的鱼。\n也可食用。
どこからか流れ着いた空き瓶。=来自某处的空瓶子。
黒いゴム製の長靴。中には何も入っていない。=黑色橡胶靴。\n里面什么都没有。
どこからか流れ着いた空き缶。=来自某处的空罐。
ものすごく堅い魚？とても食べられそうにない。=这真的是很难的鱼吗？\n它不太可能被食用。
バナナイモが採取しやすい種。=香蕉土豆很容易收集的物种。
ニガウリが採取しやすい種。=一种苦瓜很容易收集。
綿花が採取しやすい種。=棉花容易采集的物种。
赤い実が採取しやすい種。=容易收集红色水果的物种。
いろいろな種類の植物が混ざっている種。=带有各种植物混合物的种子。
活きのいい大きなカワエビ。大型の魚が好んで食いつく。=活泼的大河虾。\n大鱼更喜欢吃。
活きのいいカエル。大型魚が食いつく事がある。=一只活泼的青蛙。\n大鱼有时会咬人。
虹色の珍しいコウロギ。希少な大型の魚をおびき寄せる。=一只不寻常的彩虹色。\n捡起稀有的大鱼。
活きのいいバッタ。中型の魚をおびき出すのに向いている。=一只活泼的蚱hopper。\n适合捡中型鱼。
フルーツのニオイがする虫。希少な小型の魚をおびき寄せる。=一种闻起来像水果的昆虫。\n捡起稀有的小鱼。
活きのいいミミズ。ニオイで小型の魚が寄ってくる。=活泼的earth。\n气味和小鱼来了。
初期から選択できる釣り用の簡易的な餌。=可以从一开始就选择简单的钓鱼诱饵。
魚のすり身で作った団子。希少な中型の魚をおびき寄せる。=用鱼糜制成的饺子。\n捡起稀有的中型鱼。
水を一度沸騰させて滅菌した飲料水。体温を上げることができる。=饮用水用沸水消毒一次。\n可以升高体温。
赤い実の果汁で作ったジュース。体温を下げ、女の子の疲労を少し回復する効果がある。=由红色果汁制成的果汁。\n它具有降低体温和稍微恢复女孩疲劳的效果。
ヤシの実とバナナイモで作ったお酒。体温を平常値に戻す代わりに、女の子が眠たくなってしまう。=由棕榈坚果和香蕉土豆制成的酒。\n女孩不想让体温恢复正常，而是要睡觉。
コーヒー豆を煎じた飲み物。体温を上げることができ、女の子の目を覚ます効果もある。=一杯用咖啡豆酿造的饮料。\n它可以提高体温并唤醒女孩。
川を流れる水。体温を下げることはできるが、そのまま飲むと女の子がお腹を壊すことがある。=流经河的水。\n您可以降低体温，但是如果照原样喝，女孩可能会伤到您的胃。
汚れていない綺麗な水。のどの渇きを癒す。体温を下げることができる。=清洁干净的水。\n缓解口渴。\n可以降低体温。
タマゴを使った料理。外はフワフワで中はトロトロしている。=用鸡蛋做饭。\n外面蓬松，内部小跑。
お湯を注いで作るインスタント食品。簡単に作れて味も悪くない。=倒入热水制成的方便食品。\n易于制作，口味佳。
カニのクリームシチュー。女の子の体温を上げることもできる。=蟹膏炖。\n您还可以提高女孩的体温。
ヤシの実やバナナイモから作った甘いスープ。女の子の体温を上げることもできる。=由棕榈坚果和香蕉土豆制成的甜汤。\n您还可以提高女孩的体温。
調理過程が不明な真っ黒い何か。とても食べれそうにない。=黑色，烹饪过程未知。\n吃起来并不容易。
ニワトリのタマゴ。生で食べると女の子がお腹を壊すことがある。=鸡蛋。\n生吃时，女孩可能会断肠。
ニガウリとタマゴで作った炒め物。苦味で少し女の子の目が覚める。=用苦瓜和鸡蛋炒。\n一个小女孩带着苦涩的味道醒来。
バナナイモとニガウリで作った料理。健康に良さそうだ。=用香蕉土豆和苦瓜制成的菜。\n它看起来对您的健康有益。
ヤリマスとウズラタマゴダケを油でソテーした料理。満腹で幸せになれる。=这道菜是用鲷鱼和鹌鹑蛋炒的。\n肚子饱可以让您满意。
バナナイモを油で揚げた料理。=油煎的香蕉土豆盘在油的。
ニワトリのゆでたタマゴ。安全に食べられる。=鸡煮鸡蛋。\n吃饭要安全
魚を焼いただけの簡単な料理。=一个简单的烤鱼菜。
魚介類をふんだんに使ってダシをとった高級スープ。=优质汤和大量海鲜。
綿で作られた医療用ガーゼ。女の子のケガを直すことができる。=医用棉纱布。\n您可以修复女孩的受伤。
エッチ中に使うと、女の子の肌の艶が強くなる。=在蚀刻过程中使用时，女孩的皮肤光泽会增强。
トイレに行きたくなる特殊な薬。女の子に渡すとトイレに行きやすくなる。=一种特殊的药物，使您想去洗手间。\n传递给女孩使去洗手间更容易。
女の子にプレゼントするとエッチな気分になる。=给女孩调皮的感觉。
エッチ中に使うと、女の子がつぎ絶頂すると必ず脱力する。=如果您在做爱时使用它，当女孩屈服时，您将总是虚弱。
エッチ中に使うと、女の子がすぐに脱力から回復する。=如果在蚀刻过程中使用，女孩会立即从虚弱中恢复过来。
ひんやりする布。女の子の高温状態を治すことができる。=一块凉布。\n可以治愈女孩的高温。
眠くなる特殊な薬。女の子に渡すと寝に向かいやすくなる。=一种使您困倦的特殊药物。\n如果把它给一个女孩，它会更容易上床睡觉。
腹痛に効く薬。女の子の腹痛を治すことができる。=腹痛药。\n可以治愈女孩的腹痛。
風邪に効く薬。女の子の風邪の治りが早くなる。=感冒药。\n一个女孩的感冒治愈得更快。
魚をくわえたネコ。=有鱼的猫。
研究所に放置されていた謎の小型ロボット。何のために作られたかは不明。=一个神秘的小型机器人留在了实验室。\n未知是为了什么。
島に生息しているチョウ。綺麗な模様をしている。=居住在岛上的一只蝴蝶。\n它有一个美丽的图案。
この島に生息している野生のニワトリ。一般的なニワトリよりも卵を多く産む。=居住在这个岛上的野鸡。\n它产下的鸡蛋比典型的鸡还要多。
この島に住み着く野生のネコ。警戒心が強くなつきにくい。=居住在这个岛上的野猫。\n保持警惕，难以相处。
戦車を操縦しているネコ。=驾驶坦克的猫。
タマゴ保管庫で孵ったニワトリの雛。=我们将鸡雏放入蛋库中。
気まぐれな妖精。=异想天开的童话。
闇より出でし漆黒の精霊。=在黑暗中，漆黑的精神。
キュービーの頭を模した被り物。=模仿Cuby头饰的头饰。
様々なツールがかたどられたシャン愛用のリュック。=山族最喜欢的背包，配有各种工具。
ネコがリュックに住み着いた結果、誕生したリュック。=由于猫生活在背包中而出生的背包。
【主人公専用】バッテリーを使用した懐中電灯。装備すると夜間でも周囲を明るくしてくれる。=[仅限主角]手电筒使用电池。\n配备后，即使在晚上也可以照亮周围环境。
腕にホログラムが映し出される。ほんのり明るい。=全息图投射在手臂上。\n微亮。
お出かけ用の小さめのカバン。=一个小袋子外出。
【主人公専用】金属製のランプ。装備すると夜間でも周囲を明るくしてくれる。=[仅主角]金属灯。\n配备后，即使在晚上也可以照亮周围环境。
妖精の花が背中に生える。綺麗だが飛ぶことはできない。=童话的花朵长在背面。\n美丽，但不会飞。
腕に抱きついているキュービーのようなアクセサリ。=配件，例如小东西，拥抱着你的手臂。
【女の子専用】携帯性が上がったランプ。装備すると夜間でも周囲を明るくしてくれる。=[仅适用于女孩]便携式灯。\n配备后，即使在晚上也可以照亮周围环境。
本当に右手に黒炎をまとうことができる。=您的右手确实可以戴上黑色的火焰。
【主人公専用】暗がりを照らす松明。装備すると夜間でも周囲を明るくしてくれる。=[仅限主角]在黑暗中发光的火炬。\n配备后，即使在晚上也可以照亮周围环境。
花を編んで作った腕輪。=用针织花朵制成的手链。
頭の上で跳ね続ける不幸な魚。=一条不快乐的鱼，不断在头上弹跳。
ネコが頭を寝床として陣取っている。=一只猫用头躺在床上扎营。
頭に乗っているヒヨコ。=头上的小鸡。
木でできた古風な鳥かご。=古老鸟笼由木头制成。
ランク2のシャベル採取ポイントでアイテムを入手することが、可能になります。=现在可以获取带有2级铲子收集点的物品。
ランク2のツルハシ採取ポイントでアイテムを入手することが、可能になります。=现在可以在等级2镐收集点获得物品。
ランク2の虫網採取ポイントでアイテムを入手することが、可能になります。=现在可以在等级2的昆虫网收集点获得物品。
ランク3のシャベル採取ポイントでアイテムを入手することが、可能になります。=现在，您可以获得带有3级铲子收集点的物品。
ランク3のツルハシ採取ポイントでアイテムを入手することが、可能になります。=现在，您可以在等级3镐收集点获得物品。
動物を捕獲するときに必要なカゴ。=用来抓动物的篮子。
ランク1の虫網採取ポイントでアイテムを入手することが、可能になります。=现在可以在1级昆虫网收集点获得物品。
木で作ったシンプルな釣り竿。装備すると釣りをすることができるようになる。=一种简单的用木头制成的钓鱼竿。\n装备好之后，您就可以钓鱼了。
ランク3のハンド採取ポイントでアイテムを入手することが、可能になります。=现在，您可以获得等级为3的手收集点的物品。
ランク3の虫網採取ポイントでアイテムを入手することが、可能になります。=现在，您可以在3级昆虫网收集点获得物品。
プレゼントすると女の子の警戒が100上昇する。=礼物使女孩的机敏提高了100。
プレゼントすると女の子の人間性が50減少する。=礼物使女孩的人性减少了50％。
プレゼントすると女の子の信頼が50減少する。=送礼物会使女孩的信任减少50％。
プレゼントすると女の子の変態が50減少する。=当存在时，女孩的变态减少了50。
プレゼントすると女の子の女子力が50減少する。=如果存在，则该女孩的力量降低50。
プレゼントすると女の子の本能が50減少する。=赠送礼物会使女孩的本能降低50。
プレゼントすると女の子の社交が50減少する。=礼物会使女孩的社交减少50％。
プレゼントすると女の子の警戒が50減少する。=送礼物会使女孩的警惕性降低50。
プレゼントすると女の子の闇が50減少する。=礼物将使女孩的黑暗减少50％。
プレゼントすると女の子の本能が100上昇する。=送礼物会使女孩的本能提高100。
プレゼントすると女の子の信頼が100上昇する。=礼物使女孩的信任增加了100。
プレゼントすると女の子の変態が10上昇する。=送礼物可以使女孩的变形提高10倍。
プレゼントすると女の子の警戒が50上昇する。=赠送礼物会使女孩的警觉性提高50。
プレゼントすると女の子の信頼が10上昇する。=这份礼物使女孩的信任度提高了10。
プレゼントすると女の子の闇が10上昇する。=礼物使女孩的黑暗增加了十倍。
プレゼントすると女の子の本能が50上昇する。=送礼物会使女孩的本能增加50。
プレゼントすると女の子の人間性が10上昇する。=送礼使女孩的人性增加了10。
プレゼントすると女の子の変態が100上昇する。=送礼物会使女孩的变形提高100。
プレゼントすると女の子の社交が10上昇する。=这份礼物使女孩的社交能力提高了10。
プレゼントすると女の子の社交が100上昇する。=礼物使女孩的社交能力提高了100。
プレゼントすると女の子の女子力が50上昇する。=礼物使女孩的力量提高50。
プレゼントすると女の子の警戒が10上昇する。=礼物使女孩的警觉性提高了10。
プレゼントすると女の子の闇が100上昇する。=礼物使女孩的黑暗增加了100。
プレゼントすると女の子の女子力が10上昇する。=礼物使女孩的力量提高10。
プレゼントすると女の子の女子力が100上昇する。=送礼物会使女孩的力量提高100。
プレゼントすると女の子の社交が50上昇する。=礼物使女孩的社交活动增加了50％。
プレゼントすると女の子の信頼が50上昇する。=礼物使女孩的信任增加了50。
プレゼントすると女の子の人間性が50上昇する。=礼物使女孩的人性增加了50。
プレゼントすると女の子の闇が50上昇する。=礼物使女孩的黑暗增加了50％。
シャンが縄張りを守るために使っている錠のカギ。=Shan用来保护自己领土的钥匙锁。
作成するとエッチ中に選択できる体位「アナルバイブ挿入」が追加されます。チェストに入れても使用可能。=创建后，将添加在蚀刻过程中可以选择的位置“肛门振动插入”。\n可用于胸部。
作成するとエッチ中に選択できる体位「立ち前バイブ」「バイブ挿入」が追加されます。チェストに入れても使用可能。=如果创建它，您将能够在蚀刻“前部振动器”，“振动插入”过程中选择位置。\n可用于胸部。
作成するとエッチ中に選択できる体位「カメラ撮影オナニー」が追加されます。チェストに入れても使用可能。=创建后，将添加一个在蚀刻过程中可以选择的位置“ Camera Shooting Masturbation”。\n可用于胸部。
作成するとエッチ中に選択できる体位「拘束正常位」が追加されます。チェストに入れても使用可能。=创建后，将添加在蚀刻过程中可以选择的位置“ Restraining Normal Position”。\n可用于胸部。
炭材を固めて作った素材。軽くてしなやかだが頑丈にできている。=用硬化的木炭制成的材料\n轻巧但坚固。
島外の携帯食。お湯を入れると食べれる。=岛外的流动食品。\n你可以用热水吃。
廃材から取り出したガラスの欠片。製錬しなおせばガラスとして使えそうだ。=从小块采取的一块玻璃。\n如果再次熔化，则可以用作玻璃。
何か機械に使われていた接続端子。=在某些机器中使用的连接端子。
樹脂から精製される素材。伸縮性が強く、丈夫。=从树脂纯化的材料。\n弹力强。
樹脂から精製される素材。柔らかくて弾力がある。=从树脂纯化的材料。\n柔软有弹性。
鉄を丸めてパイプ状にした素材。=铁制的材料卷成管子。
見たことのない蓄電器。1つだけでとてつもない電力を長期間使い続けることができる。=从未见过的电池。\n只需一个，您就可以长时间继续使用强大的功能。
鉄を薄くのばして板状にした素材。=通过将铁薄薄地伸入板中而制成的材料。
廃材から取り出した手袋。ボロボロでこのままだと使えない。=手套取自废料。\n它是破烂的，不能按原样使用。
蔓を編み込んで作ったロープ。丈夫で千切れない。=用编织的藤蔓制成的绳索\n坚固耐用。
丈夫で破れにくい布。普通の布を重ね合わせている。=坚固，不易断裂的布。\n堆积一块普通的布。
丈夫で破れにくい革。様々な革が重ね合っている。=耐用且难撕的皮革。\n各种皮革都是分层的。
大量の鉄材を加工して作った素材。軽くて丈夫で光沢もよい。=通过加工大量铁制成的材料。\n轻便，结实且有光泽。
廃材から取り出した虫網。穴だらけで使えない。=取自废料的昆虫网。\n它到处都是孔，无法使用。
綿花から作られた布。柔らかくて軽い。=棉布，棉布\n轻巧柔软。
廃材。風化しているが様々な物の素材に使える。=废料。\n尽管风化，它可以用于各种材料。
廃材から取り出した釣り竿。折れていて使えない。=从废料中取出的钓鱼竿。\n它已损坏，无法使用。
木材を薄めにカットした素材。=薄木料一种通过薄切木头制成的材料。
木製のアイテムに必要な素材。=木制物品的必要材料。
廃材から取り出したシャベル。脆くなっていて使えない。=铁铲从废料中取出。\n它非常脆弱，无法使用。
廃材から取り出したツルハシ。先が欠けていて使えない。=从废物中取出镐。\n提示丢失，无法使用。
廃材から取り出した帽子。汚れていてかぶれない。=帽子从废料中取出。\n肮脏而不轻率。
天然の油。植物や魚から精製される。=天然油。\n从植物和鱼类中提炼而成。
廃材から取り出した流木。集めれば木材として使えそうだ。=从废木头采取的漂流木头。\n如果收集它，则可以将其用作木材。
木を蒸し焼きにして作った素材。=蒸木头制成的材料。
炭材と油を混ぜて作った簡易燃料。=通过混合木炭和机油制成的简单燃料。
形の整った石の素材。=一种形状良好的石材。
廃材から取り出したカバン。破れていて使えない。=从废料中取出的袋子。\n它已撕裂，无法使用。
破れた何かの革。このままでは使えそうにない。=皮革破损了。\n它不太可能照原样使用。
綿花から作られた綿。フワフワしている。=由棉花制成的棉花。\n蓬松的
脱皮した蛇の皮。一枚だけでは脆い。=去皮的蛇皮。\n单张纸很脆弱。
角張った木の柱素材。=角木支柱材料。
鉄材を加工して作った鉄素材。=通过加工铁制成的铁材料。
風化した大昔の鉄くず。まれに使えそうな鉄材が混ざっている。=风化的旧铁屑。\n几乎没有可用的铁材料。
鉄でできた素材。加工して使用する。=铁材料。\n处理和使用。
廃材から取り出した腕輪。錆びていて填められない。=从废料中取出的手镯。\n它很生锈，无法填充。
大昔に使われていた機械の回路。通電させる必要がある。=一种很久以前使用的机器电路。\n有必要通电。
他の女の子と話しやすくなる。=与其他女孩聊天变得更加容易。
飲み物の体温調節効果が半減。=饮料的温度控制效果减半。
ケガをすることが多くなる。=有很多受伤案例。
さぼって休憩をしやすくなる。=这样可以轻松地休息一下。
アイテム入手時スキルを拾いやすくなる。=获取物品时变得更容易掌握技能。
エッチな気分がすこし上昇しやすくなる。=顽皮的感觉可能会有所上升。
行動中、まれに成長が普段より早くなる。=在行动中，成长很少会比平时快。
グレード1のアイテムを拾ってきやすくなる。=较容易拾取1级物品。
疲労が溜まると、優先で休憩を取りやすくなる。=当疲劳累积时，更容易优先休息。
畑に行きやすくなり、作物の成長をすこし早めてくれる。=这使得去田间更容易，并加快了农作物的生长。
遠い場所に移動しやすくなる。=移到遥远的地方变得容易。
動物と触れ合いやすくなる。=它使与动物互动变得更加容易。
女の子がプレゼントしにくる機会が増える。=女孩有更多机会送礼物。
常に疲労がたまってしまう代わりにエッチな気分の上昇率が上がり、エッチに誘ってくることも多くなる。=顽皮情绪的增加速度不会一直保持疲倦，反而会增加，并且将邀请更多的人进行蚀刻。
ツルハシでアイテムを採取することが多くなる。=用镐挑物品更为普遍。
ご飯を食べに行きやすくなる。=吃米饭变得容易。
エッチな会話に興味をしめしやすくなる。=对调皮的对话表现出兴趣很容易。
主人公に話しかけてきやすくなる。=与英雄交谈变得更加容易。
女の子が何か物をねだりやすくなる。=它使女孩更容易乞求一些东西。
グレード3のアイテムを拾ってきやすくなる。=较容易拿到3年级的项目。
アドバイスしたときに言うことを聞きにくくなる。=当您提供建议时，很难听到您说的话。
お腹がすかなくなる。=我好饿
女の子からエッチを誘いに来ることが多くなる。=一个女孩经常来做爱。
料理をしにいくことが多くなる。=我经常去做饭。
状態異常の高温状態になりにくくなる。=变得难以成为异常状态的高温状态。
他の女の子と会話すると、相手の女の子の疲労が溜まってしまう。=与其他女孩聊天时，其他女孩的疲劳会累积。
お風呂に入れないと機嫌が悪くなる。=如果不洗澡，心情会变差。
手で採取しにいきやすくなる。=易于手工收集。
ネコを拾ってきやすくなる。=捡猫变得容易了。
エッチな会話の失敗時に機嫌がかなり悪くなる。=在顽皮的谈话失败时，心情会变得很糟。
状態異常過労にならなくなり、探索しに行きやすくなる。=它不会太劳累，并且搜索起来会更容易。
風邪をひきやすくなる。=容易感冒。
良く寝るようになる。=我睡得更好
機嫌が悪くなりやすくなる。=情绪可能会恶化。
シャベルを使って採取に行きやすくなる。=使用铲子更容易收集。
お風呂に入りにいくことが多くなる。=我经常去洗澡。
行動する度に信頼が上昇するようになり、やる気の最大値が10％アップする。=每次您采取行动时，您的信任都会增加，而您的最大动力也会增加10％。
虫網を使って採取に行きやすくなる。=使用昆虫网去收集变得容易。
やる気の最大値が10％上昇する。=最大动力提高10％。
ついてきての成功率がすこし上がる。=随之而来的成功率有所提高。
他の女の子と話すと仲良くなりやすくなる。=与其他女孩聊天可以更轻松地相处。
コールすると距離が離れていても感覚で主人公の位置を感じ取れるようになる。=打电话时，即使您不在很远的地方，也可以感觉到英雄的位置。
女の子が遊びに行くことが多くなる。=更多的女孩去玩。
ハウジングの家具を使用しにくくなる。=使用壳体的家具变得困难。
女の子が釣りをしやすくなる。=它使女孩更容易钓鱼。
雨の日でも外に出るようになる。=即使在雨天也要出去。
エッチ中に無理やり系エッチで一回でも絶頂させると、エッチ終了後に女の子の変態が少し上がる。=即使在使用系统蚀刻的蚀刻中强制执行一次，在蚀刻结束后，女孩的变形也会增加一点。
エッチ中に女主導エッチで一回でも主人公が絶頂すると、エッチ終了後に信頼が少し上がる。=如果在蚀刻过程中主人公甚至以女性主导蚀刻达到顶点，那么在蚀刻结束后信任度就会提高一点。
エッチ中にアナル系愛撫で又は挿入エッチで、女の子の快感ゲージがすこし早くなる。=在蚀刻过程中，通过肛门抚摸或插入蚀刻，女孩的愉悦感测验器更快。
エッチ中にアナル系愛撫で又は挿入エッチで女の子が一回でも絶頂すると、エッチ終了後に変態がすこし上がる。=如果女孩在蚀刻过程中甚至一次用肛门抚摸或插入蚀刻来割，则在蚀刻结束后转化率会升高一点。
エッチ中に奉仕系のエッチで主人公の快感ゲージがすこし早くなる。=在蚀刻过程中，通过与服务相关的蚀刻，英雄的愉悦感会变得更快一些。
主人公を除く女の子同士がエッチをした場合、行動終了後に変態が少し上がる。=当主角以外的女孩互相吸引时，动作结束后转换会增加一点。
女の子と同時に絶頂すると、エッチ終了時に女の子の信頼がすこし上がる。=如果您与女孩同时兼职，则在蚀刻结束时，女孩的信任度会有所提高。
エッチ中に女の子が一回も絶頂せずにエッチを終えるとエッチ終了後に、信頼が少し下がる。=当女孩完成蚀刻而没有在蚀刻过程中达到顶点时，在蚀刻结束后信任度降低了一点。
挿入系エッチ中に中出しを一回でもすると、エッチ後に女の子の本能がすこし上がる。=如果在插入系统蚀刻期间阴道射精一次，蚀刻后女孩的本能就会上升。
エッチ中にレズ系エッチで一回でも相手を絶頂させると、エッチ終了後に社交が少し上がる。=如果在蚀刻过程中通过女同性恋系统蚀刻使对方达到高潮，则蚀刻结束后的社交活动将有所增加。
エッチ中に股間挿入系エッチを選択時、主人公の快感ゲージがすこし早くなる。=当在蚀刻过程中选择the部插入系统蚀刻时，英雄的游标尺会更快一些。
エッチ中に一回でも脱力するとエッチ終了後に、信頼と闇がすこし上がる。=如果您在蚀刻过程中甚至减弱了一次，蚀刻之后信任和黑暗就会增加一点。
エッチ中に挿入系エッチ又は奉仕エッチで一回でも外出しを選ぶと、エッチ終了時に変態が少し上がる。=如果您选择在蚀刻过程中在蚀刻或服务蚀刻中至少出去一次，则转换将在蚀刻结束时上升一点。
奉仕系のエッチ中に主人公が一回でも絶頂すると、エッチ終了後に女子力が少し上がる。=如果主人公在性服务中甚至高潮一次，蚀刻结束后女孩的力量就会上升一点。
エッチな気分の初期値に5％減少する。=将顽皮情绪的初始值降低5％。
エッチ中におしっこを漏らすと、エッチ終了時に変態が少し上がる。=如果您在蚀刻过程中撒尿，则在蚀刻结束时转换会增加一点。
エッチ中に股間系愛撫エッチを選択時、女の子の快感ゲージの上昇速度がすこし上がる=在蚀刻过程中选择the型爱抚蚀刻时，女孩的游乐度数会上升得更快
エッチ中に胸系愛撫エッチを選択時、女の子の快感ゲージがすこし早くなる。=当您在蚀刻过程中选择“胸部爱媛蚀刻”时，女孩的游标会更快一些。
エッチな気分の初期値に20％上昇する。=调高到调皮情绪的初始值的20％。
<color%3D#E94321>琳</color>が寝ました=<color%3D#E94321>琳</color>睡了
プレゼントすると女の子の変態が50上昇する。=送礼物可以使女孩的变形提高50％。
プレゼントすると女の子の本能が10上昇する。=送礼使女孩的本能增加了十倍。
寝る=睡觉
睡眠=睡觉
そのまま寝転ぶ=躺下
起きる=起床
一日を終了しますか？=你想结束一天吗？
明かりを消す=关掉灯
このポイントに移動しますか=您要移动到这里吗
：拠点：廃墟=：基础：废墟
扉を開ける=开门
地面を探る=探索地面
扉を閉める=关上门
琳と話す=与琳交谈
薬をあげる=服药
アイテムを渡す=赠送礼物
アドバイスする=建议
ついてきて=跟我来
エッチがしたい=我想和你做爱
立ち去る=离开
エッチな会話=色色的谈话
おだてる=生气
お気に入りの場所は？=你最喜欢的地方是？
誰と仲良し？=你和谁在一起？
調子どう？=你好吗
印象を聞く=听印象
アドバイス=建议
料理作って=做饭
なにか飲んだら？=喝点什么吧
なにか食べたら？=吃点什么吧
採取手伝って=帮忙收集吧？
少し休んだら？=休息一下吧？
寝に行ったら？=去睡觉吧？
たまには気分転換を=偶尔改变一下心情
エッチな行動を要求=要求羞羞的行为
問題ないわ。どこへ行くの？=没问题\n你要去哪里
解散する=解散
もちろん、いい子よ。私、あなたのことをもっとよく知りたいわ=当然，好孩子。\n我想更好地认识你
そういえば、お腹がすいちゃったわね=说到这，我很饿
中を探る=探索内部
琳にアクション=アクシン动作
エッチなことをする=做羞羞的事情
エッチを開始する=开始H
ライト=轻便
Hアイテム=H项目
場所変更=位置变更
体位変更=体位变更
服=衣服
中に出す=射在里面
同時に=同时
外に出す=射到外面
挿入=插入
素股=背后素股
立ちバック=站立正面位
立位=站立后背位
愛撫=爱抚
後ろから胸もみ=从后面的揉胸
バイブ挿入=振动棒插入
立ちクンニ=站立的舔阴
奉仕=侍奉
無理やりフェラ=强迫口交
嫌がり手コキ=讨厌的打手枪
立ち手コキ=正常打手枪
上で速くなる\n下で遅くなる=快上\n慢一点
続ける=继续
Hシーンを終了しますか=H您想结束现场吗？
……どうして、普通に誘ってくれなかったの？=......为什么你不正式邀请我？
：グローブ=：地球
：シャンの家=：琳的房子

シャベルで掘る=用铲子挖
くぐる=穿过
全員を呼び出しました=叫大家
内面についてほめる=里面的赞美
容姿についてほめる=外观上的称赞
やだもう、上手なんだから=不，很好
心配しなくても、悪い印象なんてないわ=不用担心，没有不好的印象
そうねぇ……シャンとは仲良しだと思うわ=是的...我想你是我的好朋友
捕まえる=赶上
ピッケルで掘る=用稿子挖
野花の種をあげる=培养野花的种子
：拠点：森=：根据：森林
拠点=基数
セーブしますか？=您要保存吗？
セーブしました=已保存
調理台=炉灶面
あのね、あなたにとっておきのプレゼントがあるの=嘿，有特别的礼物给你
じゃじゃーん！　なんて=再见！\n什么
料理好きを手に入れた=有烹饪爱好者
サプライズは成功かしら？　ふふっ、それじゃあまたね=惊喜成功了吗？\n呵呵待会见

あそこで波の音を聞くのが好きなの。音が響いて心地いいのよ=我喜欢听那里的海浪。\n听起来很有共鸣，感觉很好
そんなこと言われたら、顔が赤くなっちゃうわ……=你说这些，你就会脸红...
立ち上がる=站起来
これにしますか？=你要这个吗？
私にくれるの？　ふふっ、ありがとう=你能给我吗？\n谢谢啦
ありがとう～、何が入ってるのかしら？=谢谢〜，里面有什么？
バッテリーを手に入れた=有电池
削除してもよろしいですか？=您确定要删除它吗？
あなたのことを、もっともっと知りたいの。だから……エッチしない？=我想进一步了解你。\n所以...你不和我做爱吗？
ごめん=对不起
いいよ=好吧
嬉しいわ……いっぱいとろけ合いましょうね=我很高兴...让我们融为一体
吐き出して=吐出来
飲みこんで=吞下
いきなり挿入する=直接插入
リードする=前戏
どう始める？=您如何开始？
階段胸もみ=楼梯上揉胸
階段手マン=楼梯上手淫
階段後背位=楼梯后背位
アイテムを使用しますか？=您使用物品吗？
壁立ちバッククンニ=墙站立背舔阴
立ちキス=站立之吻
アナル壁立ちバック=肛门墙站立
壁立ちバック=靠墙站立
あなはの元気ぃ……ついれいけれらいぉ……=你真有精力……我走不动了
琳を担ぐ=抱起
下ろす=下层
ベッドに寝かせる=上床睡觉
してほしい=我要你
ノーハンドフェラ=没有手口交
ノーハンド先舐め=无手舔
パイズリ咥え=操蛋
パイズリ舐め=舔奶
パイズリ=乳交
亀頭いじり=龟头到处乱
手コキ=打手枪
フェラ=吹箫
立ちパイズリ=乳交
立ちパイズリ舐め=站立奶舔
体にかける=穿上身体
えぇと、私……うぅん、何でもないわ=好吧，我...嗯，什么都没有。
スロット9=插槽9
スロット8=插槽8
スロット7=插槽7
スロット6=插槽6
スロット5=插槽5
スロット4=插槽4
スロット3=插槽3
スロット2=插槽2
スロット1=插槽1
スロット0=插槽0
スロット10=插槽10
スロット11=插槽11
スロット12=插槽12
スロット13=插槽13
スロット14=插槽14
スロット15=插槽15
スロット16=插槽16
スロット17=插槽17
スロット18=插槽18
スロット19=插槽19
レシピ1=食谱1
レシピ2=食谱2
レシピ3=食谱3
ランク2のハンド採取ポイントでアイテムを入手することが、可能になります。=现在可以获取等级为2的手收集点的物品。
オプション=设置
カメラ設定=镜头设定
注視点の表示=注视点显示
３人称カメラ縦速度=第三人称镜头纵速度
３人称カメラ横速度=第三人称镜头横速度
１人称カメラ縦速度=第一人称镜头纵速度
１人称カメラ横速度=第一人称镜头横速度
カメラ縦移動=镜头纵向移动
カメラ横移動=镜头横向移动
標準=标准
反転=反转
描画設定=画面设定
描画レベル=画面等级
セルフシャドウ=自身阴影
被写界深度=景深
ブルーム（光る処理）=泛光
大気表現=大气表现
SSAO=环境光遮蔽
ビネット=网格
SSR（反射）=屏幕空间反射
雨の描画=雨水画面
解像度=分辨率
半分=1/2
さらに半分=1/4
フェイスライト=面部光
環境ライト=环境光
太陽光=太阳光
キャラライト=角色光
遮蔽=遮蔽
背景色=背景色
カラー=颜色
登場制限=登场人数限制
１人目=1人
２人目=2人
３人目=3人
４人目=4人

オーディオ設定=音效设定
マスター=主音量
BGM=背景音
環境音=环境音
システムSE=系统音效
ゲームSE=游戏音效

音声設定=声音设定
機械的で無感情=三无少女
おおらかでやさしい=开朗温柔
意識が高く自信家=独立自信
自分勝手でわがまま=任性傲娇
無気力でものぐさ=懒散无力
ポジティブで明るい=积极向上
シャン=？

ゲーム設定=游戏设定
● テキスト=● 文本
サンプルテキストを表示しています=范例文本显示
文字表示速度=文字显示速度
遅=慢
速=快
自動送り待ち時間=自动台词等待时间
短=短
長=长
スキップ=跳过
既読のみ=已读
全て=全部
次のテキスト表示で音声停止=下一条文本显示前声音停止
選択肢後スキップ継続=分支选项后跳过剧情
選択肢後オート継続=分支选项后自动继续
テキストウィンドウオプション=文本窗口设置

● フィールド=● 场景
操作ガイド表示=操作指导显示
ストーリーヘルプ表示=故事帮助显示
ミニマップ表示=迷你地图显示
中央ポインター表示=中央指针表示
女の子のパラメーターロック=女孩参数锁定

エッチシーン設定=H场景设定
主人公の表示=主角显示
主人公の男根=主角的丁丁
主人公の服=主角的服装
主人公のアクセサリー=主角的饰品
主人公の靴=主角的鞋子
主人公を単色化=主角单色化
単色カラー=单色颜色
透明度=透明度
汁表示=汁液显示
なし=无
詳細=详细
簡易=简易
尿=尿液
常に=通常
ゲーム準拠=游戏特效
潮吹き=潮吹
艶=潮红
快感ゲージ表示=性奋度显示
メニューアイコン表示=说明图标显示
フィニッシュボタン表示=结束按钮显示
カメラ初期化判断=镜头初始化判断
する=是
しない=否
１人目 視線=单人视线
１人目 首の向き=单人头部朝向
２人目 視線=双人视线
２人目 首の向き=双人头部朝向
カメラ見る=面向镜头

タイトルに戻る=返回标题菜单
Game Start=開始遊戯
Character Creation=角色定制
Options=設置
Quit=退出
Female=女性
Male=男性
Back=返回
終了しますか？=要结束游戏吗？
確定=确定
キャンセル=取消
Press Any Button=按任意鍵繼續
初期化する=设定初始化
設定を初期化しますか？=要把设定初始化吗？
保存して終了=保存退出
保存しないで終了=不保存退出
キャラ編集を終了しますか？=要结束角色编辑吗？

————————————————————————————————————

sr:"^([0-9]{2}) ([\S\s]+)$"=$1 $2
r:"^カラー([0-9①-⑨]+)$"=颜色 $1
r:"^調整([0-9①-⑨]+)$"=调整 $1
r:"^タイプ([0-9０-９]+)$"=类型 $1


ツボミ=蕾

フェイス=面部
顔周り=面部周围
顔のタイプ=脸型
全体=全体
顎=下巴
頬=脸颊
眉=眉毛
目=眼睛
鼻=鼻子
口=嘴巴
耳=耳朵
ホクロの設定=痣的设定
目周り=眼睛详细设定
左右の設定を合わせる=左右眼设定相同
左目=左眼
右目=右眼
瞳の設定=瞳孔设定
目のハイライト=眼睛高光
眉のタイプ=眉毛类型
まつ毛のタイプ=睫毛类型
化粧=化妆
アイシャドウ=眼影
チーク=腮红
リップ=嘴唇
ペイント01=彩绘01
ペイント02=彩绘02
————————————————————————————————————
輪郭=轮廓
シワ=皱纹
タイプ０１=类型01
タイプ０２=类型02
タイプ03=类型03
タイプ04=类型04
タイプ05=类型05
タイプ06=类型06
タイプ07=类型07
タイプ08=类型08
タイプ09=类型09
タイプ10=类型10
タイプ11=类型11
タイプ12=类型12
タイプ13=类型13
タイプ14=类型14
タイプ15=类型15
タイプ16=类型16
タイプ17=类型17
タイプ18=类型18
タイプ19=类型19
タイプ20=类型20
タイプ21=类型21
タイプ22=类型22
タイプ23=类型23
強さ=强弱
ほうれい線=法令纹
目元シワ=眼睛皱纹
口元シワ=嘴巴皱纹
全体シワ1=全体皱纹1
全体シワ2=全体皱纹2
目元補助1=眼睛補助1
目元補助2=眼睛補助2
目元補助3=眼睛補助3
目元補助4=眼睛補助4
目元補助5=眼睛補助5
目元補助6=眼睛補助6
目元補助7=眼睛補助7
形状補助1=形状補助1
形状補助2=形状補助2
形状補助3=形状補助3
唇強調=强调嘴唇
頬コケ=脸颊
頬盛り=腮帮子
顔全体横幅=头部宽度
顔上部前後=上半脸前后
顔上部上下=上半脸高度
顔下部横幅=下半脸宽度
顔下部前後=下半脸前后
顎横幅=下巴宽度
顎上下=下巴高度
顎前後=下巴前后
顎角度=下巴角度
顎下部上下=下颚高度
顎先幅=下巴尖宽度
顎先上下=下巴尖高度
顎先前後=下巴尖前后
頬下部上下=下脸颊高度
頬下部前後=下脸颊前后
頬下部幅=下脸颊宽度
頬上部上下=上脸颊高度
頬上部前後=上脸颊前后
頬上部幅=上脸颊宽度
眉の幅=眉毛宽度
眉の高さ=眉毛高度
眉の位置X=眉毛位置X轴
眉の位置Y=眉毛位置Y轴
眉の傾き=眉毛倾斜
目上下=眼睛高度
目横位置=眼睛间距
目前後=眼睛前后
目の横幅=眼睛宽度
目の縦幅=眼睛深度
目の角度Z軸=眼睛角度Z轴
目の角度Y軸=眼睛角度Y轴
目頭左右位置=内眼角左右位置
目頭上下位置=内眼角上下位置
目尻左右位置=外眼角左右位置
目尻上下位置=外眼角上下位置
まぶた形状１=眼睑形状1
まぶた形状２=眼睑形状2
鼻全体上下=鼻子高度
鼻全体前後=鼻子前后
鼻全体角度X軸=鼻子角度
鼻全体横幅=鼻子宽度
鼻筋高さ=鼻梁高度
鼻筋横幅=鼻梁宽度
鼻筋形状=鼻梁形状
小鼻横幅=小鼻宽度
小鼻上下=小鼻高度
小鼻前後=小鼻前后
小鼻角度X軸=小鼻角度X轴
小鼻角度Z軸=小鼻角度Z轴
鼻先サイズ=鼻尖尺寸
鼻先高さ=鼻尖高度
鼻先角度X軸=鼻尖角度X轴
口上下=嘴巴高度
口横幅=嘴巴宽度
口縦幅=嘴巴厚度
口前後位置=嘴巴前后位置
口形状上=嘴巴形状上
口形状下=嘴巴形状下
口形状口角=嘴角
耳サイズ=耳朵尺寸
耳角度Y軸=耳朵角度Y轴
耳角度Z軸=耳朵角度Z轴
耳上部形状=耳尖形状
耳下部形状=耳垂形状
種類=种类
配置=配置
ホクロ=痣
ホクロ２=痣2
ソバカス=雀斑
ソバカス２=雀斑2
ホクロの高さ=痣的高度
ホクロの幅=痣的宽度
ホクロの位置Y=痣的位置Y轴
ホクロの位置X=痣的位置X轴
左の口元=左嘴角
右の口元=右嘴角
左の口上=左嘴上
右の口上=右嘴上
左の目元=左眼
右の目元=右眼
そばかす=雀斑
額中央=额中央
タイプ1=类型01
タイプ2=类型02
タイプ3=类型03
タイプ4=类型04
タイプ5=类型05
タイプ6=类型06
タイプ7=类型07
タイプ8=类型08
タイプ9=类型09
瞳の種類=眼睛种类
瞳の設定=眼睛设定
瞳孔種類=瞳孔种类
瞳孔設定=瞳孔设定
発光=发光
幅=宽度
高さ=高度
白目=眼白
高さ調整=高度调整
影の範囲=阴影范围
調整=调整
X位置=X轴位置
Y位置=Y轴位置
傾き=倾斜
タイプ24=类型24
タイプ25=类型25
タイプ26=类型26
タイプ27=类型27
タイプ28=类型28
タイプ29=类型29
タイプ30=类型30
タイプ31=类型31
タイプ32=类型32
タイプ33=类型33
タイプ34=类型34
タイプ35=类型35
タイプ36=类型36
タイプ37=类型37
タイプ38=类型38
タイプ39=类型39
タイプ40=类型40
タイプ41=类型41
タイプ42=类型42
タイプ43=类型43
タイプ44=类型44
光源反射=光源反射
ツヤ=光泽
質感=质感
回転=旋转
位置X=位置X轴
位置Y=位置Y轴
左頬=左脸颊
右頬=右脸颊
おでこ=前额
瞳=眼睛
ハート=心
星=星
三日月=三日月
陰陽=阴阳
水滴=水滴
バラ=玫瑰
絆創膏=创可贴
キスマーク=吻痕
クモの巣=蜘蛛网
クモ=蜘蛛
蝶=蝴蝶
禁止=禁止
汚れ=污渍
十字=十字
五十字=五十字
瞳２=眼睛2
円=圆
四角=四角
ピラミッド=金字塔
ぼかし円=圆晕
ひっかき線=划痕
バースト=爆裂
ドットサークル=点环
三角１=三角1
三角２=三角2
六芒星=六芒星
イバラ=荆棘
炎月=炎月
手形=手形
猫=猫
ヒカリ=光
ソヨギ１=杉树1
ソヨギ２=杉树2
花１=花1
花２=花2
一棒線=一条杠
二棒線=两条杠

————————————————————————————————————

ボディ=身体
体型=体型
胸=胸部
上半身=上半身
下半身=下半身
腕=手臂
脚=腿部
肌=皮肤
肌の種類=皮肤种类
日焼け跡=晒痕
乳首=乳头
アンダーヘア=阴毛
爪の色=指甲颜色
特殊=特殊
ふたなり=大屌萌妹

————————————————————————————————————
身長=身高
頭サイズ=头部尺寸
胸サイズ=胸部尺寸
胸上下位置=胸部上下位置
胸の尖り=胸部凸起
胸の左右位置=胸部左右位置
胸の重さ=胸部重量
胸の柔らかさ=胸部柔软度
胸の左右開き=胸部外扩程度
胸上下角度=胸部上下角度
乳輪の大きさ=乳晕大小
乳輪の膨らみ=乳晕凸起
乳首太さ=乳头大小
乳首立ち=乳头凸起
首周り奥=脖子厚度
首周り幅=脖子宽度
胴体下奥=下身厚度
胴体肩周り奥=肩膀厚度
胴体上幅=上身宽度
胴体肩周り幅=肩膀宽度
胴体下幅=下身宽度
胴体上奥=上身厚度
ウエスト位置=腰部位置
腰下幅=骨盆宽度
腰下奥=骨盆厚度
腰上奥=腰部厚度
腰上幅=腰部宽度
尻=屁股
尻角度=屁股角度
肩=肩膀
上腕=上臂
前腕=前臂
太もも上=上大腿
太もも下=下大腿
ふくらはぎ=小腿肚
足首=脚踝
タイプ１=类型01
タイプ２=类型02
タイプ３=类型03
タイプ４=类型04
肉感=肉感
肉感の強さ=肉感强度
スレンダー=苗条
普通=普通
ムキムキ=肌肉
ポッチャリ=丰满
カラーサンプル=颜色范例
ランジェリーライン=女士内衣
チューブトップライン=抹胸
ワンピースライン１=连衣裙1
ワンピースライン２=连衣裙2
スクール水着ライン=死库水
ビキニライン=比基尼
マイクロライン１=小型比基尼1
マイクロライン２=小型比基尼2
スポーツライン=运动衣
体操着ライン=体操服
ナチュラルライン1=自然晒痕1
ナチュラルライン2=自然晒痕2
レーシングライン=竞赛泳衣
キャミソールライン=吊带
小三角=小三角
円形=圆形
薄円形=薄圆形
小円形=小圆形
Iライン=I形
細Iライン=细I形
長菱=菱形
まばら=稀疏
ナチュラル=自然
薄小=薄小
薄四角=薄四角
大三角=大三角
腹・股間=腹部
背中・うなじ=背部
右脚裏=右腿后方
右ふくらはぎ=右小腿肚
左脚裏=左腿后方
左ふくらはぎ=左小腿肚
腰=腰
左脚=左腿
右脚=右腿
右スネ=右胫
左スネ=左胫
右足=右脚
左足=左脚
右尻=右屁股
左尻=左屁股
右肩=右肩
左肩=左肩
右腕=右腕
左腕=左腕
————————————————————————————————————

ヘアー=发型
前髪と後ろ髪の色を統一=前发与后发颜色统一
根本と毛先の色を自動設定=发根与发梢颜色自动设定
髪の調整をまとめて行う=头发一起调整
後ろ髪=后发
後ろ髪の設定=后发设定
前髪=前发
前髪の設定=前发设定
横髪=侧发
横髪の設定=侧发设定
エクステ=额外
エクステの設定=额外设定
タイプ01=类型01
タイプ02=类型02
————————————————————————————————————
髪設定=头发设定
操作軸設定=操作轴设定
全ての操作軸=全部操作轴
速度=速度
移動=移动
大きさ=尺寸
調整01=调整01
調整02=调整02
調整03=调整03
調整04=调整04
調整05=调整05
移動X=移动X轴
移動Y=移动Y轴
移動Z=移动Z轴
回転X=旋转X轴
回転Y=旋转Y轴
回転Z=旋转Z轴
操作軸=操作轴
揺らさない=禁止摇动
全て初期化=全部初始化
基本カラー=基本颜色
滑らかさ=平滑
細ツインテール=细双马尾
セミロング=半长发
ぱっつんロング=齐长发
外はねショート=外羽短发
ショートヘア=短发
ツインロール=双马尾卷发
ウェーブロング=波浪长发
ロングヘア=长发
くせっ毛ショート=卷短发
三つ編み=麻花辫
細三つ編み=细麻花辫
横あほ毛=横呆毛
2本あほ毛=2根呆毛
上向きあほ毛=冲天呆毛
前あほ毛=前呆毛
お団子=团子头
カール=卷发
太もみあげ=粗鬓角
ロングもみあげ=长鬓角
細もみあげ=细鬓角
ポニーおくれ毛=马尾
編みカチューシャ=编发箍
後ろ編み込み=后编发
姫カット=公主头
横おさげ=横辫
ツイン前おさげ=前双辫
後ろおさげ=后辫
はねっけロング=羽毛长发
外はねミディアム=外羽中发
ぱっつんミディアム=齐中发
ボリュームポニー=马尾
ストレートロング=直长发
くせっけショート=卷短发
横分け=中分
エムバング=三分
梳き髪=梳发
片目隠し=遮住眼睛
でこだし中わけ=高中分
ぱっつんミデイアム=齐中发
切り揃えショート=剪齐短发
はねっ毛=羽毛发
細ロングツインテール=细长双马尾
ロングツインロール=长双马尾卷发
アシンメトリ=不对称
————————————————————————————————————
コーデ=服装
衣装=衣服
トップス=上衣
ボトムス=下衣
インナー上=胸罩
インナー下=内裤
手袋=手套
パンスト=裤袜
靴下=袜子
靴=鞋子
衣装カード=服装卡
保存・消去=保存・删除
読込み=读取
————————————————————————————————————
カラー①=颜色①
カラー②=颜色②
カラー③=颜色③
その他=其他
初期カラー=初始颜色
破れ具合=破损程度
カラー01=颜色01
カラー02=颜色02
カラー03=颜色03
カラー04=颜色04
カラー1=颜色1
カラー2=颜色2
カラー3=颜色3
柄=花纹
柄設定=花纹设定
オプションパーツ01を表示=可选部件01显示
オプションパーツ02を表示=可选部件02显示
消去=删除
上書き保存=覆盖保存
新規保存=新存档
服読込み=服装读取
全て読込み=全部读取
装飾読込み=装饰读取
レンガ=砖块
ストライプ=竖条纹
ヒョウ=豹纹
ボーダー=横条纹
チェックA=方格子A
千鳥格子=千鸟格子
水玉=水玉
網=网
イチゴ=草莓
ハーリキンチェック=花斑方格
チェックB=方格子B
星B=星星B
迷彩=迷彩
編み込み=编织
青海波=水波
麻の葉=麻叶纹
唐草=卷草纹
矢絣=箭羽
鹿子=鹿纹
ノルデック=北欧
亀甲花菱=龟甲花形
星A=星星A
グラデーションボーダー=渐变纹
ドクロ=骷髅
花柄=花纹
縦線=竖线
モザイク=马赛克
横線=横线
チマヨ=奇马约条纹
アーガイル=阿盖尔菱形
変則ストライプ=不规则横条纹
ギンガムチェック=条格子
変則ボーダー=不规则竖条纹
丸=圆
ハイビスカス=木槿
スポーツ=运动
南国リーフ=热带树叶
ゼブラ=斑马
市松=黑白格子
ストライプ細=细竖条纹
ペイズリー=佩兹利花纹
エイシェント=蚀刻纹
コーディネート名=服装名称
決定=决定
戻る=返回
No Name=无名称
日付=日期
名前=名字

————————————————————————————————————
アクセサリー=饰品
スロット=插槽
コピー=复制
コピーする=执行复制
親=位置
頭=头
眼鏡=眼镜
顔=面部
背中=背部
手=手
下腹部=下腹部
移動量=移动量
位置=位置
回転量=旋转量
拡縮量=缩放量
拡縮=缩放
初期化=初始化
————————————————————————————————————
ツイン右=右马尾
ツイン左=左马尾
ポニー=马尾
ヘアピン左=左发夹
ヘアピン右=右发夹
帽子=帽子
額=额头
頭中心=头中心
左耳=左耳
右耳=右耳
胸上=胸上
胸上中央=胸上中央
左胸=左胸
右胸=右胸
背中中央=后背中央
背中左=左后背
背中右=右后背
腰前=腰前
腰後ろ=腰后
腰左=腰左
腰右=腰右
かかと左=左脚跟
左中指=左中指
左手=左手
左肘=左肘
左上腕=左上臂
左人差指=左食指
左太もも=左大腿
左手首=左手腕
左薬指=左无名指
左ひざ=左膝
左足首=左脚踝
かかと右=右脚跟
右中指=右中指
右手=右手
右肘=右肘
右上腕=右上臂
右人差指=右食指
右太もも=右大腿
右手首=右手腕
右薬指=右无名指
右ひざ=右膝
右足首=右脚踝
下腹部③=下腹部③
下腹部②=下腹部②
下腹部①=下腹部①
初期親=初始位置
————————————————————————————————————

設定=设定
キャラ設定=角色设定
名前・誕生日=名字・生日
タイプ=类型
願望=愿望
キャラカード=角色卡
融合=融合
システム=系统
状態設定表示=状态设定显示
ウィンドウ配置の初期化=窗口设置初始化
スライダーホイール操作=滚轮操作
タイトルに戻りますか？=要返回标题菜单吗？
キャラメイクを終了しますか？=要结束角色定制吗？
いいえ=否
はい=是
————————————————————————————————————
名前・誕生日=名字・生日
ランダム=随机
誕生日=生日
月=月
日=日
声質=音色
女の子に求める願望（最大３つ）=对女孩的愿望（最多3个）
やさしさ=温柔
快楽=快乐
小悪魔=小恶魔
刺激=刺激
礼儀=礼仪
禁断=禁断
落ち着き=安静
お金=拜金
知性=知性
信念=信念
忠誠=忠诚
持久力=持久
可憐さ=可怜
無邪気=天真
不完全=有缺陷
理解力=理解力
判断力=判断力
癒やし=治愈系
本当に削除しますか？=真的要删除吗?
本当に上書きしますか？=真的要覆盖吗?
体=身材
髪=发型
キャラカードA=角色卡A
キャラカードB=角色卡B
掛け合わせる=合体
終了=结束
————————————————————————————————————
状態設定=状态设定
視線=视线
カメラ=镜头
正面=正面
首=脖子
ポーズ=姿势
ポーズ再生=暂停动作
服状態=衣服状态
自動=自动
着衣=穿衣
下着=内衣
全裸=全裸
装飾=装饰
表示=显示
非表示=不显示
ライト向きX=光线方向X轴
ライト向きY=光线方向Y轴
ライト強さ=光线强度
背景=背景
単色=单色
画像=图像
色合い=色彩
鮮やかさ=鲜艳度
明るさ=亮度
サンプル=范例
左クリックで適用=点击左键使用
左クリックで現在のカラーを登録=点击左键保存现在的颜色
左クリックで適応、右クリックで削除=点击左键使用、点击右键删除
撮影メニュー=摄影菜单
口の開き=嘴巴张开
目の開き=眼睛睁开
前面フレーム=相框
背面フレーム=背景
保存=保存
ヒゲのタイプ=胡须类型


上衣
ワンピース=连体
Tシャツ=T恤
ミニＴ=迷你T恤
グダミニＴ=露肩迷你T恤
チビＴ=露胸T恤
キャミソールA=吊带A
キャミソールB=吊带B
キャミソールC=吊带C
ベアトップ=暴露装
ブラウス=女式衬衫
ブラウス襟開き=露胸衬衫
シャツワンピース=衬衫连衣裙
サロペット=背带裤
裸サロペット=裸体背带裤
ネックパーカー=卫衣
裸パーカー=裸体卫衣
スポーツウェア=运动衣
ロングパレオ=长浴巾
南国ベアトップフリル=南国褶边露肩装
南国キャミソール=南国吊带
タイトドレス=紧身裙
フレアシャツ=喇叭衬衫
ノースリーブニット=无袖针织衫
カーディガンキャミソール=开襟毛线吊带
カーディガンシャツ=开襟毛线衬衫
裸カーディガン=裸体开襟毛衣
ボディーハーネス=身体背带
スーツ=制服
スーツキャミソール=吊带制服
スーツ前開き=开胸制服
ブレザー=西装夹克
セーラー服=水手服
体操着=体操服
セーラー襟=水手衣襟
ココナッツブラ=椰子胸罩
サマーニット=夏日针织衫
サマードレス=夏日裙
カクテルドレス=混合裙
オープンショルダー=露肩装
ニットキャミソール=针织吊带
トレッキングウェア=登山装
シンプルドレス=简易裙
リボンキャミソール=丝带吊带
キュートジャケット=漂亮外套
ノースリーブタートル=无袖露脐装
ノースリーブラウス=无袖女式衬衫

下衣
ショートパンツ=短裤
ホットパンツ=热裤
スポーツパンツ=运动裤
プリーツスカート=百褶裙
ミニスカート=迷你裙
タイトスカート=紧身裙
バックスリットタイト=后开叉紧身裙
ミニタイトスカート=迷你紧身裙
ショートレギンス=短紧身裤
ジーンズ=牛仔裤
スーツパンツ=制服裤子
ブルマ=女式短裤
パレオ=沙滩巾
南国スカート=南国裙
腰蓑=草裙
レザースカート=皮革裙
ストレッチパンツ=弹力裤
フロントリボン=丝带裤
ラップスカート=RAP裙

胸罩
ノーマル=普通
リボンレース=丝带蕾丝
アダルティレース=成人蕾丝
ハーフレース=半蕾丝
フルレース=全蕾丝
マイクロレース=小型蕾丝
ストラップレス=无肩带
バンド=绑带
ビキニ=比基尼
リボンビキニ=丝带比基尼
マイクロビキニ=小型比基尼
マイクロSビキニ=微型比基尼
ツイスト=扭带
旧スクール水着=死库水
競泳水着=竞赛泳衣
ハートシール=爱心贴
スターシール=星星贴
絆創膏=创可贴

内裤
ハイレッグ=高叉内裤
Ｔバック=丁字裤

手套
軍手=工作手套
革手袋=皮革手套
革手袋左手=左手皮革手套
ロングレングス=长手套
フィンガーグローブ=指套

裤袜
ストッキング=裤袜
ストッキングTカバー=丁字裤袜
ストッキングHカバー=加厚裤袜
レースストッキング=蕾丝裤袜
網タイツ細目=网袜（细）
網タイツ中目=网袜（中）
網タイツ大目=网袜（大）
穴あきストッキング=开裆裤袜
スパッツA=紧身裤袜A
スパッツB=紧身裤袜B
ショートスパッツ=紧身短裤袜
シンプルガーター=吊带袜
レースガーター=蕾丝吊带
ベルトガーター=皮带吊带

袜子
ソックス=短袜
ハイソックス=高帮袜
ニーソックス=过膝袜
スニーカーソックス=运动袜
ルーズソックス=宽松袜
サイハイ=长筒袜
シースルーサイハイ=内穿长筒袜
フットガーターニーソ=皮带袜
パンプスカバー=浅口袜

鞋子
ビーチサンダル=沙滩凉鞋
ボーンサンダル=绑带凉鞋
ローファー=平底鞋
パンプス=舞鞋
ベルトパンプス=皮带舞鞋
ランニングシューズ=跑步鞋
スニーカー=轻便运动鞋
メッシュシューズ=网鞋
カフシューズ=卷边鞋
トレッキング=登山鞋
マリンシューズ=潮鞋
上履き=室内鞋
レザーブーツ＆チャップス=高帮皮靴

饰品

头
ヘアピン=短发夹
髪留め=发夹
宝石の髪飾り=宝石发饰
翼の髪飾り=飞翼发饰
花のコサージュ=花饰
ポニークリップ=马尾发箍
リボン=丝带
カチューシャ=发箍
ヘッドホン=耳机
サンバイザー=遮阳帽
うさ耳リボン=爽哥
猫耳=猫耳
ヘルメット=头盔
麦わら帽子=草帽
王冠=王冠
シルクハット=礼帽
貝殻=贝壳
キノコ=蘑菇
うなぎ=鳗鱼
カニ=螃蟹
スイカ=西瓜
スイカヘッド=西瓜头
基本図形：キューブ=基本图形：方块
基本図形：スフィア=基本图形：球
基本図形：シリンダー=基本图形：圆柱
基本図形：カプセル=基本图形：胶囊
基本図形：コーン=基本图形：圆锥
基本図形：ピラミッド=基本图形：金字塔
基本図形：クリスタル=基本图形：水晶
基本図形：リング=基本图形：圆环
基本図形：スター=基本图形：星星
基本図形：ハート=基本图形：心
お団子髪=团子头
あほ毛=呆毛
はねあほ毛=两根呆毛
三つ編みカチューシャ=麻花辫发箍
カールエクステ=额外卷发
おくれ毛=飘散的头发
細おくれ毛=细长飘散的头发

耳朵
スター=星星
スターリング=星星环
クリスタル=水晶
クリスタルピラー=水晶柱
三連イヤリング=三连耳环
フラワー=花朵
パール=珍珠

眼镜
スクエア=方形眼镜
オーバル=椭圆眼镜
ウェリントン=惠灵顿眼镜
ボストン=波士顿眼镜
ブロウ=半框眼镜
アンダーリム=下框眼镜
鼻掛け眼鏡=挂鼻眼镜
メタルラウンド=金属圆眼镜
メタルオーバル=金属椭圆眼镜
メタルアンダーリム=金属下框眼镜
水泳ゴーグル=泳镜
ゴーグル=潜水镜
ライトゴーグル=偏光镜
布目隠し=用布遮住眼睛
アイマスクA=眼罩A
アイマスクB=眼罩B
パピヨン=蝴蝶
医療用眼帯右用=医疗右眼罩
医療用眼帯左用=医疗左眼罩
眼帯右用=右眼罩
眼帯左用=左眼罩

面部
ピエロの鼻=小丑鼻
天狗の鼻=天狗鼻
一輪のバラ=一束玫瑰
リコーダー=竖笛
顔包帯右=头部右绷带
顔包帯左=头部左绷带
口当て布=口罩
バードマスク=鸟面具

脖子
ハートネックレス=心形项链
ストーンネックレス=宝石项链
リングネックレス=圆环项链
フックネックレス=钩子项链
ネイチャーネックレス=自然项链
カラーストーンネックレス=彩石项链
フラワーネックレス=花环项链
シルバーハートネックレス=银心项链
ネクタイリボン=丝领带
ネクタイ=领带
ルーズネクタイA=松领带A
ルーズネクタイB=松领带B
スカーフ=围巾
革の首輪=皮革颈环
拘束用首輪=拘束颈环
レースチョーカー=蕾丝项圈
ラインチョーカー=线项圈
フラワーレイ=花圈
商人のマフラー=商人围巾
商人のネックレス=商人项链
コアキューブ=核心方块
ゴールドチョーカー=黄金项圈
チェーンネックレス=锁链项链

肩膀
トートバッグ=单肩背包
スクールバッグ=学校背包
オウムのおもちゃ=鹦鹉
ミニショルダー=小肩包

胸部
シンプルリング=乳环
ジュエルリング=宝石乳环
洗濯バサミ=洗衣夹
ローター=跳蛋
クリップ=夹子

腰
ウエストバッグ=腰包
浮き輪A=泳圈A
浮き輪B=泳圈B
鍵束=钥匙链
手錠=手铐
鞭=鞭子
猫シッポ=猫尾
商人の道具入れ=商人道具包

背部
リュック=背包
革鞄=皮革书包
シャチフロート=海豚浮标
ダンボール=纸箱
商人カバン=商人袋子

手臂
腕章A=臂章A
腕章B=臂章B
レザーアーム=皮革护臂
アームレット=臂环
バンダナ巻き=手帕卷

手
シンプル指輪=戒指
ツインリング=对戒
宝石の指輪A=宝石戒指A
宝石の指輪B=宝石戒指B
スカルヘッド=骷髅头
チアポンポン=啦啦队
レザーバングル=皮革护腕
イルカとカラーストーン=海豚手链
腕時計=手表
丸型腕時計=圆手表
メタルブレスレット=金属手环
シュシュ=布艺环
ストーンブレスレット=宝石手环
リストバンドA=护腕A
リストバンドB=护腕B
光輪=光轮
スマートウォッチ=智能手表
スポーツブレスレット=运动手环
ツイストリング=扭曲手环
薬瓶の腕輪=药瓶手环

腿部
レースガーターリング左=蕾丝左腿环
レースガーターリング右=蕾丝右腿环
ティアアンクレット=宝石脚环
ガーターリング左=皮革左腿环
ガーターリング右=皮革右腿环
ミサンガA左=左腿编织带A
ミサンガB左=左腿编织带B
ミサンガA右=右腿编织带A
ミサンガB右=右腿编织带B

下体
ディルドー=假阳具
バイブ=震动棒
アナルバイブ=菊花震动棒

コピー元を選択=选择复制源
コピー先を選択=选择复制目的地
調整①を上下反転=调整①上下反转
調整②を上下反転=调整②上下反转
調整①を左右反転=调整①左右反转
調整②を左右反転=调整②左右反转
調整①=调整①
調整②=调整②
スロットをコピー=复制插槽
左右の親を変更=改变左右位置
調整値のコピー=复制调整值

男主
Yシャツ(A)=衬衣A
Yシャツ(B)=衬衣B
ポロシャツ=POLO衫
ジャケット=夹克
ベスト =服务生
作業着=工作服
タンクトップ（A）=背心A
タンクトップ（B）=背心B
ロングカーディガン =开襟毛线长衫

七分丈パンツ=七分裤
ハーフパンツ=中裤
裾おりパンツ=卷起裤腿
作業着ズボン=工作裤
サーフパンツ=冲浪裤
デニムパンツ=牛仔裤

ビジネスシューズ=商务鞋



